"cod_setor","situacao_setor","homens_soma","mulheres_soma","total","homens_percentual","mulheres_percentual","domicilio"
"250010605000001","1","277","157","434","63.824884792626726","36.1751152073732740","HOMEM"
"250010605000002","1","89","59","148","60.135135135135140","39.8648648648648600","HOMEM"
"250010605000003","1","156","139","295","52.881355932203390","47.1186440677966100","HOMEM"
"250010605000004","8","173","44","217","79.723502304147460","20.2764976958525340","HOMEM"
"250010605000005","5","102","97","199","51.256281407035175","48.7437185929648250","HOMEM"
"250010605000006","8","69","88","157","43.949044585987260","56.0509554140127400","MULHER"
"250010605000007","8","67","31","98","68.367346938775510","31.6326530612244880","HOMEM"
"250010605000008","8","101","30","131","77.099236641221370","22.9007633587786260","HOMEM"
"250010605000009","8","137","44","181","75.690607734806630","24.3093922651933700","HOMEM"
"250010605000010","8","114","30","144","79.166666666666670","20.8333333333333320","HOMEM"
"250010605000011","1","213","117","330","64.545454545454550","35.4545454545454500","HOMEM"
"250010605000012","5","36","13","49","73.469387755102050","26.5306122448979600","HOMEM"
"250010605000013","5","24","14","38","63.157894736842100","36.8421052631579000","HOMEM"
"250010605000014","8","100","38","138","72.463768115942030","27.5362318840579730","HOMEM"
"250020505000001","1","193","120","313","61.661341853035150","38.3386581469648500","HOMEM"
"250020505000002","1","153","83","236","64.830508474576280","35.1694915254237300","HOMEM"
"250020505000003","8","80","21","101","79.207920792079210","20.7920792079207930","HOMEM"
"250020505000004","8","76","9","85","89.411764705882350","10.5882352941176470","HOMEM"
"250020505000005","8","32","3","35","91.428571428571430","8.5714285714285710","HOMEM"
"250020505000006","8","113","39","152","74.342105263157890","25.6578947368421060","HOMEM"
"250020505000007","8","100","25","125","80.000000000000000","20.0000000000000000","HOMEM"
"250020505000008","8","53","6","59","89.830508474576280","10.1694915254237280","HOMEM"
"250020505000009","8","161","68","229","70.305676855895200","29.6943231441048030","HOMEM"
"250020505000010","8","9","1","10","90.000000000000000","10.0000000000000000","HOMEM"
"250020505000011","1","203","111","314","64.649681528662430","35.3503184713375800","HOMEM"
"250030405000001","1","128","108","236","54.237288135593220","45.7627118644067800","HOMEM"
"250030405000002","1","180","165","345","52.173913043478260","47.8260869565217400","HOMEM"
"250030405000003","1","174","120","294","59.183673469387756","40.8163265306122440","HOMEM"
"250030405000004","1","72","62","134","53.731343283582090","46.2686567164179100","HOMEM"
"250030405000005","1","116","62","178","65.168539325842700","34.8314606741573060","HOMEM"
"250030405000006","1","79","76","155","50.967741935483870","49.0322580645161300","HOMEM"
"250030405000007","1","135","67","202","66.831683168316830","33.1683168316831700","HOMEM"
"250030405000008","1","145","96","241","60.165975103734440","39.8340248962655600","HOMEM"
"250030405000009","1","191","126","317","60.252365930599370","39.7476340694006300","HOMEM"
"250030405000010","1","186","174","360","51.666666666666664","48.3333333333333360","HOMEM"
"250030405000011","1","32","102","134","23.880597014925375","76.1194029850746300","MULHER"
"250030405000012","1","132","55","187","70.588235294117650","29.4117647058823500","HOMEM"
"250030405000013","1","102","60","162","62.962962962962960","37.0370370370370400","HOMEM"
"250030405000014","1","20","51","71","28.169014084507044","71.8309859154929600","MULHER"
"250030405000015","1","177","150","327","54.128440366972480","45.8715596330275200","HOMEM"
"250030405000016","8","127","162","289","43.944636678200695","56.0553633217993050","MULHER"
"250030405000017","8","29","3","32","90.625000000000000","9.3750000000000000","HOMEM"
"250030405000018","5","252","122","374","67.379679144385020","32.6203208556149700","HOMEM"
"250030405000019","5","105","40","145","72.413793103448270","27.5862068965517220","HOMEM"
"250030405000020","8","79","23","102","77.450980392156860","22.5490196078431400","HOMEM"
"250030405000021","8","53","38","91","58.241758241758240","41.7582417582417600","HOMEM"
"250030405000022","8","35","26","61","57.377049180327866","42.6229508196721340","HOMEM"
"250030405000023","8","43","21","64","67.187500000000000","32.8125000000000000","HOMEM"
"250030405000024","8","6","0","6","100.000000000000000","0.0000000000000000","HOMEM"
"250030405000025","8","46","67","113","40.707964601769910","59.2920353982300900","MULHER"
"250030405000026","8","6","2","8","75.000000000000000","25.0000000000000000","HOMEM"
"250030405000027","8","52","22","74","70.270270270270270","29.7297297297297300","HOMEM"
"250030405000028","8","151","38","189","79.894179894179900","20.1058201058201040","HOMEM"
"250030405000029","8","109","39","148","73.648648648648650","26.3513513513513500","HOMEM"
"250030405000030","5","216","79","295","73.220338983050850","26.7796610169491520","HOMEM"
"250030405000031","5","60","282","342","17.543859649122810","82.4561403508771900","MULHER"
"250030405000032","8","75","28","103","72.815533980582530","27.1844660194174740","HOMEM"
"250030405000033","8","62","17","79","78.481012658227850","21.5189873417721530","HOMEM"
"250030405000034","8","51","43","94","54.255319148936174","45.7446808510638260","HOMEM"
"250030405000035","8","60","9","69","86.956521739130440","13.0434782608695650","HOMEM"
"250030405000036","8","173","24","197","87.817258883248730","12.1827411167512680","HOMEM"
"250030405000037","1","86","96","182","47.252747252747255","52.7472527472527450","MULHER"
"250030405000038","1","120","85","205","58.536585365853660","41.4634146341463400","HOMEM"
"250030405000039","1","119","89","208","57.211538461538460","42.7884615384615400","HOMEM"
"250030405000040","1","209","133","342","61.111111111111114","38.8888888888888860","HOMEM"
"250030405000041","1","92","86","178","51.685393258426960","48.3146067415730400","HOMEM"
"250030405000042","1","144","88","232","62.068965517241380","37.9310344827586200","HOMEM"
"250030405000043","1","99","97","196","50.510204081632650","49.4897959183673500","HOMEM"
"250030405000044","1","109","142","251","43.426294820717130","56.5737051792828700","MULHER"
"250040305000001","1","200","116","316","63.291139240506330","36.7088607594936700","HOMEM"
"250040305000002","1","205","125","330","62.121212121212125","37.8787878787878750","HOMEM"
"250040305000003","1","242","124","366","66.120218579234970","33.8797814207650300","HOMEM"
"250040305000004","1","113","240","353","32.011331444759210","67.9886685552407900","MULHER"
"250040305000005","1","118","84","202","58.415841584158414","41.5841584158415860","HOMEM"
"250040305000006","1","195","133","328","59.451219512195124","40.5487804878048760","HOMEM"
"250040305000007","1","196","187","383","51.174934725848566","48.8250652741514340","HOMEM"
"250040305000008","1","122","98","220","55.454545454545450","44.5454545454545500","HOMEM"
"250040305000009","8","104","18","122","85.245901639344270","14.7540983606557370","HOMEM"
"250040305000010","8","112","15","127","88.188976377952760","11.8110236220472440","HOMEM"
"250040305000011","8","254","82","336","75.595238095238100","24.4047619047619050","HOMEM"
"250040305000012","8","76","31","107","71.028037383177580","28.9719626168224300","HOMEM"
"250040305000013","8","105","29","134","78.358208955223890","21.6417910447761200","HOMEM"
"250040305000014","8","140","90","230","60.869565217391305","39.1304347826086950","HOMEM"
"250040305000015","8","231","63","294","78.571428571428570","21.4285714285714270","HOMEM"
"250040305000016","8","169","33","202","83.663366336633660","16.3366336633663350","HOMEM"
"250040305000017","5","91","37","128","71.093750000000000","28.9062500000000000","HOMEM"
"250040305000018","8","299","65","364","82.142857142857140","17.8571428571428580","HOMEM"
"250040305000019","8","66","19","85","77.647058823529400","22.3529411764705870","HOMEM"
"250040305000020","8","171","51","222","77.027027027027030","22.9729729729729720","HOMEM"
"250040305000021","8","130","32","162","80.246913580246910","19.7530864197530850","HOMEM"
"250040305000022","8","68","20","88","77.272727272727270","22.7272727272727270","HOMEM"
"250040305000023","1","83","71","154","53.896103896103895","46.1038961038961050","HOMEM"
"250040305000024","1","126","55","181","69.613259668508290","30.3867403314917120","HOMEM"
"250050205000001","1","177","96","273","64.835164835164830","35.1648351648351700","HOMEM"
"250050205000002","1","143","121","264","54.166666666666664","45.8333333333333360","HOMEM"
"250050205000003","1","167","106","273","61.172161172161175","38.8278388278388250","HOMEM"
"250050205000004","1","225","118","343","65.597667638483970","34.4023323615160400","HOMEM"
"250050205000005","1","206","120","326","63.190184049079754","36.8098159509202460","HOMEM"
"250050205000006","1","221","147","368","60.054347826086950","39.9456521739130500","HOMEM"
"250050205000007","1","176","133","309","56.957928802588995","43.0420711974110050","HOMEM"
"250050205000008","1","212","108","320","66.250000000000000","33.7500000000000000","HOMEM"
"250050205000009","8","78","23","101","77.227722772277230","22.7722772277227700","HOMEM"
"250050205000010","8","108","31","139","77.697841726618700","22.3021582733812950","HOMEM"
"250050205000011","8","72","27","99","72.727272727272730","27.2727272727272730","HOMEM"
"250050205000012","8","82","37","119","68.907563025210080","31.0924369747899160","HOMEM"
"250050205000013","8","120","29","149","80.536912751677850","19.4630872483221470","HOMEM"
"250050205000014","8","70","23","93","75.268817204301070","24.7311827956989240","HOMEM"
"250050205000015","8","48","6","54","88.888888888888890","11.1111111111111100","HOMEM"
"250050205000016","8","30","68","98","30.612244897959183","69.3877551020408100","MULHER"
"250050205000017","8","167","54","221","75.565610859728510","24.4343891402714900","HOMEM"
"250050205000018","5","62","19","81","76.543209876543220","23.4567901234567900","HOMEM"
"250050205000019","5","40","16","56","71.428571428571430","28.5714285714285730","HOMEM"
"250053605000001","1","103","90","193","53.367875647668390","46.6321243523316100","HOMEM"
"250053605000002","1","105","116","221","47.511312217194570","52.4886877828054300","MULHER"
"250053605000003","8","66","41","107","61.682242990654200","38.3177570093458000","HOMEM"
"250053605000004","5","54","64","118","45.762711864406780","54.2372881355932200","MULHER"
"250053605000005","8","76","84","160","47.500000000000000","52.5000000000000000","MULHER"
"250053605000006","8","44","88","132","33.333333333333336","66.6666666666666700","MULHER"
"250053605000007","8","105","102","207","50.724637681159420","49.2753623188405800","HOMEM"
"250053605000008","8","32","12","44","72.727272727272730","27.2727272727272730","HOMEM"
"250053605000009","1","120","103","223","53.811659192825110","46.1883408071748900","HOMEM"
"250053605000010","5","106","54","160","66.250000000000000","33.7500000000000000","HOMEM"
"250057705000001","1","85","122","207","41.062801932367150","58.9371980676328500","MULHER"
"250057705000002","8","110","40","150","73.333333333333330","26.6666666666666680","HOMEM"
"250057705000003","8","33","32","65","50.769230769230770","49.2307692307692300","HOMEM"
"250057705000004","8","64","41","105","60.952380952380950","39.0476190476190500","HOMEM"
"250057705000005","1","28","118","146","19.178082191780820","80.8219178082191800","MULHER"
"250060105000001","1","164","88","252","65.079365079365080","34.9206349206349200","HOMEM"
"250060105000002","1","174","158","332","52.409638554216870","47.5903614457831300","HOMEM"
"250060105000003","1","189","64","253","74.703557312252970","25.2964426877470350","HOMEM"
"250060105000004","1","132","68","200","66.000000000000000","34.0000000000000000","HOMEM"
"250060105000005","1","116","129","245","47.346938775510200","52.6530612244898000","MULHER"
"250060105000006","1","91","63","154","59.090909090909090","40.9090909090909100","HOMEM"
"250060105000007","1","106","61","167","63.473053892215570","36.5269461077844300","HOMEM"
"250060105000008","1","84","23","107","78.504672897196260","21.4953271028037400","HOMEM"
"250060105000009","8","87","59","146","59.589041095890410","40.4109589041095900","HOMEM"
"250060105000010","8","41","1","42","97.619047619047620","2.3809523809523810","HOMEM"
"250060105000011","8","77","20","97","79.381443298969070","20.6185567010309300","HOMEM"
"250060105000012","8","89","39","128","69.531250000000000","30.4687500000000000","HOMEM"
"250060105000013","8","14","0","14","100.000000000000000","0.0000000000000000","HOMEM"
"250060105000014","8","138","22","160","86.250000000000000","13.7500000000000000","HOMEM"
"250060105000015","5","282","121","403","69.975186104218370","30.0248138957816370","HOMEM"
"250060105000016","5","146","43","189","77.248677248677250","22.7513227513227500","HOMEM"
"250060105000017","8","84","14","98","85.714285714285710","14.2857142857142860","HOMEM"
"250060105000018","8","25","6","31","80.645161290322580","19.3548387096774200","HOMEM"
"250060105000019","1","132","105","237","55.696202531645570","44.3037974683544300","HOMEM"
"250060105000020","1","81","45","126","64.285714285714290","35.7142857142857150","HOMEM"
"250060105000021","1","80","37","117","68.376068376068370","31.6239316239316250","HOMEM"
"250060105000022","1","82","60","142","57.746478873239440","42.2535211267605600","HOMEM"
"250060105000023","1","177","83","260","68.076923076923080","31.9230769230769230","HOMEM"
"250060105000024","1","217","119","336","64.583333333333330","35.4166666666666640","HOMEM"
"250060105000025","1","171","63","234","73.076923076923080","26.9230769230769230","HOMEM"
"250060105000026","8","26","5","31","83.870967741935490","16.1290322580645160","HOMEM"
"250060105000027","5","177","80","257","68.871595330739300","31.1284046692607000","HOMEM"
"250060105000028","5","111","38","149","74.496644295302020","25.5033557046979880","HOMEM"
"250060105000029","5","98","12","110","89.090909090909100","10.9090909090909080","HOMEM"
"250070005000001","1","176","147","323","54.489164086687300","45.5108359133127000","HOMEM"
"250070005000002","1","154","88","242","63.636363636363630","36.3636363636363700","HOMEM"
"250070005000003","1","159","113","272","58.455882352941174","41.5441176470588260","HOMEM"
"250070005000004","1","199","114","313","63.578274760383390","36.4217252396166100","HOMEM"
"250070005000005","1","123","108","231","53.246753246753244","46.7532467532467560","HOMEM"
"250070005000006","1","252","136","388","64.948453608247420","35.0515463917525800","HOMEM"
"250070005000007","8","93","41","134","69.402985074626870","30.5970149253731340","HOMEM"
"250070005000008","8","159","73","232","68.534482758620680","31.4655172413793100","HOMEM"
"250070005000009","8","107","35","142","75.352112676056340","24.6478873239436600","HOMEM"
"250070005000010","8","101","152","253","39.920948616600790","60.0790513833992100","MULHER"
"250070005000011","8","82","29","111","73.873873873873880","26.1261261261261280","HOMEM"
"250070005000012","8","96","21","117","82.051282051282060","17.9487179487179500","HOMEM"
"250070005000013","8","177","36","213","83.098591549295780","16.9014084507042240","HOMEM"
"250070005000014","8","68","13","81","83.950617283950620","16.0493827160493830","HOMEM"
"250070005000015","8","86","35","121","71.074380165289260","28.9256198347107440","HOMEM"
"250070005000016","8","120","20","140","85.714285714285710","14.2857142857142860","HOMEM"
"250070005000017","8","77","126","203","37.931034482758620","62.0689655172413800","MULHER"
"250070005000018","8","91","37","128","71.093750000000000","28.9062500000000000","HOMEM"
"250070005000019","5","114","36","150","76.000000000000000","24.0000000000000000","HOMEM"
"250070005000020","1","117","136","253","46.245059288537550","53.7549407114624500","MULHER"
"250070005000021","5","117","50","167","70.059880239520960","29.9401197604790430","HOMEM"
"250070015000001","1","41","13","54","75.925925925925920","24.0740740740740730","HOMEM"
"250070015000002","8","104","82","186","55.913978494623656","44.0860215053763440","HOMEM"
"250070015000003","8","199","50","249","79.919678714859440","20.0803212851405630","HOMEM"
"250070015000004","8","70","13","83","84.337349397590360","15.6626506024096380","HOMEM"
"250070015000005","8","186","27","213","87.323943661971820","12.6760563380281700","HOMEM"
"250070015000006","8","94","14","108","87.037037037037040","12.9629629629629640","HOMEM"
"250070015000007","5","222","38","260","85.384615384615390","14.6153846153846150","HOMEM"
"250073405000001","1","111","96","207","53.623188405797100","46.3768115942029000","HOMEM"
"250073405000002","8","127","35","162","78.395061728395060","21.6049382716049370","HOMEM"
"250073405000003","8","101","33","134","75.373134328358200","24.6268656716417900","HOMEM"
"250073405000004","1","78","55","133","58.646616541353380","41.3533834586466200","HOMEM"
"250077505000001","1","106","119","225","47.111111111111114","52.8888888888888860","MULHER"
"250077505000002","1","127","200","327","38.837920489296636","61.1620795107033640","MULHER"
"250077505000003","8","234","66","300","78.000000000000000","22.0000000000000000","HOMEM"
"250077505000004","8","104","146","250","41.600000000000000","58.4000000000000000","MULHER"
"250077505000005","8","83","64","147","56.462585034013610","43.5374149659863900","HOMEM"
"250077505000006","8","157","17","174","90.229885057471260","9.7701149425287350","HOMEM"
"250077505000007","5","74","54","128","57.812500000000000","42.1875000000000000","HOMEM"
"250077505000008","1","156","83","239","65.271966527196650","34.7280334728033500","HOMEM"
"250077505000009","1","171","93","264","64.772727272727270","35.2272727272727300","HOMEM"
"250077505000010","5","42","54","96","43.750000000000000","56.2500000000000000","MULHER"
"250077505000011","5","27","30","57","47.368421052631580","52.6315789473684200","MULHER"
"250080905000001","1","173","142","315","54.920634920634920","45.0793650793650800","HOMEM"
"250080905000002","1","161","109","270","59.629629629629626","40.3703703703703740","HOMEM"
"250080905000003","1","172","145","317","54.258675078864350","45.7413249211356500","HOMEM"
"250080905000004","1","181","124","305","59.344262295081970","40.6557377049180300","HOMEM"
"250080905000005","1","206","104","310","66.451612903225810","33.5483870967741900","HOMEM"
"250080905000006","1","170","92","262","64.885496183206100","35.1145038167938900","HOMEM"
"250080905000007","8","60","19","79","75.949367088607600","24.0506329113924050","HOMEM"
"250080905000008","8","72","13","85","84.705882352941170","15.2941176470588240","HOMEM"
"250080905000009","8","31","12","43","72.093023255813950","27.9069767441860460","HOMEM"
"250080905000010","8","36","7","43","83.720930232558150","16.2790697674418600","HOMEM"
"250080905000011","8","75","19","94","79.787234042553200","20.2127659574468100","HOMEM"
"250080905000012","8","135","16","151","89.403973509933780","10.5960264900662260","HOMEM"
"250080905000013","8","124","31","155","80.000000000000000","20.0000000000000000","HOMEM"
"250080905000014","8","133","32","165","80.606060606060610","19.3939393939393940","HOMEM"
"250080905000015","8","59","28","87","67.816091954023000","32.1839080459770100","HOMEM"
"250080905000016","8","145","23","168","86.309523809523810","13.6904761904761900","HOMEM"
"250080905000017","8","122","69","191","63.874345549738220","36.1256544502617800","HOMEM"
"250080905000018","8","73","19","92","79.347826086956520","20.6521739130434770","HOMEM"
"250080905000019","8","50","6","56","89.285714285714290","10.7142857142857140","HOMEM"
"250080905000020","8","64","18","82","78.048780487804880","21.9512195121951240","HOMEM"
"250080905000021","8","55","10","65","84.615384615384610","15.3846153846153850","HOMEM"
"250080905000022","8","73","14","87","83.908045977011500","16.0919540229885070","HOMEM"
"250080905000023","8","31","7","38","81.578947368421050","18.4210526315789500","HOMEM"
"250080905000024","8","152","29","181","83.977900552486190","16.0220994475138130","HOMEM"
"250080905000025","8","27","9","36","75.000000000000000","25.0000000000000000","HOMEM"
"250080905000026","8","94","33","127","74.015748031496060","25.9842519685039370","HOMEM"
"250080905000027","8","100","19","119","84.033613445378150","15.9663865546218490","HOMEM"
"250080905000028","8","56","28","84","66.666666666666670","33.3333333333333360","HOMEM"
"250080905000029","8","25","28","53","47.169811320754720","52.8301886792452800","MULHER"
"250080905000030","8","10","15","25","40.000000000000000","60.0000000000000000","MULHER"
"250080905000031","8","58","5","63","92.063492063492060","7.9365079365079370","HOMEM"
"250080905000032","5","108","27","135","80.000000000000000","20.0000000000000000","HOMEM"
"250080905000033","5","92","8","100","92.000000000000000","8.0000000000000000","HOMEM"
"250080905000034","5","85","36","121","70.247933884297520","29.7520661157024800","HOMEM"
"250080905000035","5","4","1","5","80.000000000000000","20.0000000000000000","HOMEM"
"250080905000036","1","162","91","253","64.031620553359690","35.9683794466403100","HOMEM"
"250080905000037","5","146","80","226","64.601769911504420","35.3982300884955700","HOMEM"
"250080905000038","5","7","9","16","43.750000000000000","56.2500000000000000","MULHER"
"250090805000001","1","118","134","252","46.825396825396820","53.1746031746031800","MULHER"
"250090805000002","1","114","90","204","55.882352941176470","44.1176470588235300","HOMEM"
"250090805000003","1","164","149","313","52.396166134185300","47.6038338658147000","HOMEM"
"250090805000004","1","142","158","300","47.333333333333336","52.6666666666666640","MULHER"
"250090805000005","1","70","76","146","47.945205479452056","52.0547945205479440","MULHER"
"250090805000006","1","94","73","167","56.287425149700596","43.7125748502994040","HOMEM"
"250090805000007","1","164","97","261","62.835249042145590","37.1647509578544100","HOMEM"
"250090805000008","1","70","72","142","49.295774647887320","50.7042253521126800","MULHER"
"250090805000009","1","123","100","223","55.156950672645740","44.8430493273542600","HOMEM"
"250090805000010","8","112","23","135","82.962962962962960","17.0370370370370380","HOMEM"
"250090805000011","8","131","57","188","69.680851063829790","30.3191489361702120","HOMEM"
"250090805000012","8","105","23","128","82.031250000000000","17.9687500000000000","HOMEM"
"250090805000013","8","81","26","107","75.700934579439250","24.2990654205607480","HOMEM"
"250090805000014","8","107","28","135","79.259259259259250","20.7407407407407400","HOMEM"
"250090805000015","8","204","120","324","62.962962962962960","37.0370370370370400","HOMEM"
"250090805000016","1","98","105","203","48.275862068965516","51.7241379310344840","MULHER"
"250090805000017","1","120","120","240","50.000000000000000","50.0000000000000000","IGUAL"
"250090805000018","1","146","103","249","58.634538152610440","41.3654618473895600","HOMEM"
"250090805000019","1","105","89","194","54.123711340206185","45.8762886597938150","HOMEM"
"250100505000001","1","180","104","284","63.380281690140850","36.6197183098591500","HOMEM"
"250100505000002","1","194","133","327","59.327217125382260","40.6727828746177400","HOMEM"
"250100505000003","1","126","48","174","72.413793103448270","27.5862068965517220","HOMEM"
"250100505000004","1","108","89","197","54.822335025380710","45.1776649746192900","HOMEM"
"250100505000005","1","171","97","268","63.805970149253730","36.1940298507462700","HOMEM"
"250100505000006","1","136","71","207","65.700483091787430","34.2995169082125600","HOMEM"
"250100505000007","1","170","113","283","60.070671378091870","39.9293286219081300","HOMEM"
"250100505000008","8","79","124","203","38.916256157635466","61.0837438423645340","MULHER"
"250100505000009","8","83","18","101","82.178217821782180","17.8217821782178230","HOMEM"
"250100505000010","8","66","29","95","69.473684210526320","30.5263157894736850","HOMEM"
"250100505000011","8","101","22","123","82.113821138211380","17.8861788617886200","HOMEM"
"250100505000012","8","125","38","163","76.687116564417180","23.3128834355828230","HOMEM"
"250100505000013","8","123","30","153","80.392156862745100","19.6078431372549030","HOMEM"
"250100505000014","5","277","117","394","70.304568527918780","29.6954314720812180","HOMEM"
"250100505000015","8","53","33","86","61.627906976744185","38.3720930232558150","HOMEM"
"250100505000016","8","79","13","92","85.869565217391300","14.1304347826086950","HOMEM"
"250100505000017","8","148","29","177","83.615819209039540","16.3841807909604530","HOMEM"
"250100505000018","8","241","65","306","78.758169934640520","21.2418300653594760","HOMEM"
"250100505000019","5","69","7","76","90.789473684210520","9.2105263157894740","HOMEM"
"250100505000020","8","254","83","337","75.370919881305640","24.6290801186943600","HOMEM"
"250100505000021","7","66","10","76","86.842105263157890","13.1578947368421040","HOMEM"
"250100505000022","5","47","6","53","88.679245283018870","11.3207547169811310","HOMEM"
"250100505000023","5","78","19","97","80.412371134020620","19.5876288659793830","HOMEM"
"250100505000024","1","79","123","202","39.108910891089110","60.8910891089108900","MULHER"
"250100505000025","1","164","128","292","56.164383561643840","43.8356164383561600","HOMEM"
"250100505000026","1","63","149","212","29.716981132075470","70.2830188679245300","MULHER"
"250100505000027","1","169","75","244","69.262295081967210","30.7377049180327870","HOMEM"
"250110405000001","1","71","46","117","60.683760683760680","39.3162393162393200","HOMEM"
"250110405000002","1","95","77","172","55.232558139534880","44.7674418604651200","HOMEM"
"250110405000003","1","101","99","200","50.500000000000000","49.5000000000000000","HOMEM"
"250110405000004","1","118","51","169","69.822485207100600","30.1775147928994100","HOMEM"
"250110405000005","1","105","104","209","50.239234449760765","49.7607655502392350","HOMEM"
"250110405000006","1","91","78","169","53.846153846153850","46.1538461538461500","HOMEM"
"250110405000007","1","145","137","282","51.418439716312060","48.5815602836879400","HOMEM"
"250110405000008","1","107","123","230","46.521739130434780","53.4782608695652200","MULHER"
"250110405000009","1","126","101","227","55.506607929515420","44.4933920704845800","HOMEM"
"250110405000010","1","102","41","143","71.328671328671330","28.6713286713286700","HOMEM"
"250110405000011","8","77","34","111","69.369369369369370","30.6306306306306300","HOMEM"
"250110405000012","8","98","11","109","89.908256880733940","10.0917431192660560","HOMEM"
"250110405000013","5","69","100","169","40.828402366863905","59.1715976331360950","MULHER"
"250110405000014","8","20","31","51","39.215686274509810","60.7843137254901900","MULHER"
"250110405000015","8","34","4","38","89.473684210526320","10.5263157894736850","HOMEM"
"250110405000016","8","49","5","54","90.740740740740750","9.2592592592592600","HOMEM"
"250110405000017","8","32","5","37","86.486486486486480","13.5135135135135140","HOMEM"
"250110405000018","8","27","5","32","84.375000000000000","15.6250000000000000","HOMEM"
"250110405000019","8","93","11","104","89.423076923076920","10.5769230769230770","HOMEM"
"250110405000020","8","104","10","114","91.228070175438600","8.7719298245614040","HOMEM"
"250110405000021","8","53","21","74","71.621621621621630","28.3783783783783800","HOMEM"
"250110405000022","1","13","3","16","81.250000000000000","18.7500000000000000","HOMEM"
"250110405000023","1","98","82","180","54.444444444444440","45.5555555555555600","HOMEM"
"250110405000024","1","85","58","143","59.440559440559440","40.5594405594405600","HOMEM"
"250110405000025","1","38","66","104","36.538461538461540","63.4615384615384600","MULHER"
"250110405000026","1","112","45","157","71.337579617834400","28.6624203821656070","HOMEM"
"250110405000027","1","149","94","243","61.316872427983540","38.6831275720164600","HOMEM"
"250110405000028","1","134","100","234","57.264957264957270","42.7350427350427300","HOMEM"
"250110405000029","1","87","67","154","56.493506493506494","43.5064935064935060","HOMEM"
"250110405000030","1","100","97","197","50.761421319796950","49.2385786802030500","HOMEM"
"250110405000031","1","104","81","185","56.216216216216220","43.7837837837837800","HOMEM"
"250110410000001","1","113","69","182","62.087912087912090","37.9120879120879100","HOMEM"
"250110410000002","8","92","41","133","69.172932330827070","30.8270676691729340","HOMEM"
"250110410000003","8","22","11","33","66.666666666666670","33.3333333333333360","HOMEM"
"250110410000004","8","103","27","130","79.230769230769230","20.7692307692307700","HOMEM"
"250110410000005","8","56","24","80","70.000000000000000","30.0000000000000000","HOMEM"
"250110415000001","1","172","107","279","61.648745519713260","38.3512544802867400","HOMEM"
"250110415000002","8","161","42","203","79.310344827586200","20.6896551724137940","HOMEM"
"250110415000003","8","83","16","99","83.838383838383830","16.1616161616161630","HOMEM"
"250110415000004","8","19","18","37","51.351351351351354","48.6486486486486460","HOMEM"
"250110415000005","8","17","6","23","73.913043478260870","26.0869565217391300","HOMEM"
"250110420000001","1","48","25","73","65.753424657534250","34.2465753424657500","HOMEM"
"250110420000002","8","31","24","55","56.363636363636370","43.6363636363636300","HOMEM"
"250110420000003","8","79","40","119","66.386554621848750","33.6134453781512600","HOMEM"
"250110420000004","8","46","132","178","25.842696629213480","74.1573033707865200","MULHER"
"250110420000005","8","11","10","21","52.380952380952380","47.6190476190476200","HOMEM"
"250110420000006","8","54","28","82","65.853658536585370","34.1463414634146360","HOMEM"
"250110420000007","8","79","48","127","62.204724409448820","37.7952755905511800","HOMEM"
"250110420000008","8","35","32","67","52.238805970149250","47.7611940298507500","HOMEM"
"250115305000001","1","201","66","267","75.280898876404490","24.7191011235955070","HOMEM"
"250115305000002","5","64","20","84","76.190476190476190","23.8095238095238100","HOMEM"
"250115305000003","8","25","14","39","64.102564102564100","35.8974358974359000","HOMEM"
"250115305000004","8","42","15","57","73.684210526315800","26.3157894736842100","HOMEM"
"250115305000005","8","36","5","41","87.804878048780500","12.1951219512195120","HOMEM"
"250120305000001","1","119","213","332","35.843373493975900","64.1566265060241000","MULHER"
"250120305000002","1","112","72","184","60.869565217391305","39.1304347826086950","HOMEM"
"250120305000003","1","105","218","323","32.507739938080500","67.4922600619195100","MULHER"
"250120305000004","1","191","165","356","53.651685393258425","46.3483146067415750","HOMEM"
"250120305000005","8","43","68","111","38.738738738738740","61.2612612612612600","MULHER"
"250120305000006","8","1","5","6","16.666666666666668","83.3333333333333300","MULHER"
"250120305000007","8","48","48","96","50.000000000000000","50.0000000000000000","IGUAL"
"250120305000008","8","219","78","297","73.737373737373740","26.2626262626262630","HOMEM"
"250120305000009","1","178","68","246","72.357723577235770","27.6422764227642260","HOMEM"
"250130205000001","1","174","111","285","61.052631578947370","38.9473684210526300","HOMEM"
"250130205000002","1","155","65","220","70.454545454545450","29.5454545454545470","HOMEM"
"250130205000003","1","127","86","213","59.624413145539904","40.3755868544600960","HOMEM"
"250130205000004","1","37","150","187","19.786096256684490","80.2139037433155100","MULHER"
"250130205000005","1","70","100","170","41.176470588235300","58.8235294117647000","MULHER"
"250130205000006","1","74","161","235","31.489361702127660","68.5106382978723500","MULHER"
"250130205000007","1","108","55","163","66.257668711656440","33.7423312883435600","HOMEM"
"250130205000008","1","154","73","227","67.841409691629960","32.1585903083700440","HOMEM"
"250130205000009","8","49","22","71","69.014084507042260","30.9859154929577480","HOMEM"
"250130205000010","8","24","6","30","80.000000000000000","20.0000000000000000","HOMEM"
"250130205000011","8","81","32","113","71.681415929203540","28.3185840707964600","HOMEM"
"250130205000012","8","129","50","179","72.067039106145240","27.9329608938547480","HOMEM"
"250130205000013","8","90","22","112","80.357142857142860","19.6428571428571420","HOMEM"
"250130205000014","8","166","68","234","70.940170940170940","29.0598290598290600","HOMEM"
"250130205000015","8","114","48","162","70.370370370370370","29.6296296296296300","HOMEM"
"250130205000016","8","146","44","190","76.842105263157890","23.1578947368421060","HOMEM"
"250130205000017","8","153","41","194","78.865979381443300","21.1340206185567000","HOMEM"
"250130205000018","8","147","25","172","85.465116279069760","14.5348837209302320","HOMEM"
"250130205000019","8","41","56","97","42.268041237113400","57.7319587628866000","MULHER"
"250130205000020","8","59","23","82","71.951219512195120","28.0487804878048760","HOMEM"
"250130205000021","8","103","23","126","81.746031746031750","18.2539682539682530","HOMEM"
"250130205000022","8","53","26","79","67.088607594936700","32.9113924050632900","HOMEM"
"250130205000023","8","88","24","112","78.571428571428570","21.4285714285714270","HOMEM"
"250130205000024","8","134","51","185","72.432432432432440","27.5675675675675700","HOMEM"
"250130205000025","1","135","63","198","68.181818181818190","31.8181818181818170","HOMEM"
"250130205000026","1","156","61","217","71.889400921658990","28.1105990783410140","HOMEM"
"250130205000027","1","172","120","292","58.904109589041100","41.0958904109589000","HOMEM"
"250130205000028","5","36","12","48","75.000000000000000","25.0000000000000000","HOMEM"
"250130220000001","1","150","40","190","78.947368421052630","21.0526315789473700","HOMEM"
"250130220000002","8","108","63","171","63.157894736842100","36.8421052631579000","HOMEM"
"250130220000003","8","95","56","151","62.913907284768214","37.0860927152317860","HOMEM"
"250130220000004","8","0","0","0",NULL,NULL,NULL
"250130220000005","8","0","0","0",NULL,NULL,NULL
"250130220000006","1","122","102","224","54.464285714285715","45.5357142857142850","HOMEM"
"250135105000001","1","99","176","275","36.000000000000000","64.0000000000000000","MULHER"
"250135105000002","1","141","90","231","61.038961038961040","38.9610389610389600","HOMEM"
"250135105000003","8","50","5","55","90.909090909090900","9.0909090909090920","HOMEM"
"250135105000004","8","106","11","117","90.598290598290600","9.4017094017094020","HOMEM"
"250135105000005","1","178","61","239","74.476987447698750","25.5230125523012570","HOMEM"
"250135105000006","1","68","57","125","54.400000000000000","45.6000000000000000","HOMEM"
"250140105000001","1","82","46","128","64.062500000000000","35.9375000000000000","HOMEM"
"250140105000002","1","101","98","199","50.753768844221106","49.2462311557788940","HOMEM"
"250140105000003","1","107","49","156","68.589743589743590","31.4102564102564100","HOMEM"
"250140105000004","1","161","95","256","62.890625000000000","37.1093750000000000","HOMEM"
"250140105000005","1","84","47","131","64.122137404580160","35.8778625954198500","HOMEM"
"250140105000006","7","23","24","47","48.936170212765960","51.0638297872340400","MULHER"
"250140105000007","7","145","60","205","70.731707317073170","29.2682926829268300","HOMEM"
"250140105000008","7","60","128","188","31.914893617021278","68.0851063829787200","MULHER"
"250140105000009","7","45","91","136","33.088235294117645","66.9117647058823500","MULHER"
"250140105000010","7","36","9","45","80.000000000000000","20.0000000000000000","HOMEM"
"250140105000011","7","36","10","46","78.260869565217390","21.7391304347826100","HOMEM"
"250140105000012","7","37","8","45","82.222222222222230","17.7777777777777800","HOMEM"
"250140105000013","7","30","8","38","78.947368421052630","21.0526315789473700","HOMEM"
"250140105000014","7","179","112","291","61.512027491408936","38.4879725085910640","HOMEM"
"250140105000015","8","10","3","13","76.923076923076920","23.0769230769230770","HOMEM"
"250140105000016","8","13","9","22","59.090909090909090","40.9090909090909100","HOMEM"
"250140105000017","7","65","32","97","67.010309278350520","32.9896907216494800","HOMEM"
"250140105000018","7","8","14","22","36.363636363636370","63.6363636363636300","MULHER"
"250140105000019","7","8","11","19","42.105263157894740","57.8947368421052600","MULHER"
"250140105000020","7","5","7","12","41.666666666666664","58.3333333333333360","MULHER"
"250150005000001","1","139","152","291","47.766323024054984","52.2336769759450160","MULHER"
"250150005000002","1","71","131","202","35.148514851485146","64.8514851485148500","MULHER"
"250150005000003","1","159","77","236","67.372881355932210","32.6271186440678000","HOMEM"
"250150005000004","1","136","113","249","54.618473895582326","45.3815261044176740","HOMEM"
"250150005000005","1","100","101","201","49.751243781094530","50.2487562189054700","MULHER"
"250150005000006","1","174","112","286","60.839160839160840","39.1608391608391600","HOMEM"
"250150005000007","1","15","2","17","88.235294117647060","11.7647058823529420","HOMEM"
"250150005000008","8","60","110","170","35.294117647058826","64.7058823529411700","MULHER"
"250150005000009","8","137","35","172","79.651162790697670","20.3488372093023240","HOMEM"
"250150005000010","8","164","36","200","82.000000000000000","18.0000000000000000","HOMEM"
"250150005000011","8","126","172","298","42.281879194630875","57.7181208053691250","MULHER"
"250150005000012","8","0","0","0",NULL,NULL,NULL
"250150005000013","8","33","2","35","94.285714285714290","5.7142857142857140","HOMEM"
"250150005000014","8","26","9","35","74.285714285714290","25.7142857142857150","HOMEM"
"250150005000015","8","99","26","125","79.200000000000000","20.8000000000000000","HOMEM"
"250150005000016","8","25","10","35","71.428571428571430","28.5714285714285730","HOMEM"
"250150005000017","1","119","192","311","38.263665594855304","61.7363344051446960","MULHER"
"250150005000018","1","49","33","82","59.756097560975610","40.2439024390243900","HOMEM"
"250150005000019","5","93","40","133","69.924812030075190","30.0751879699248120","HOMEM"
"250150005000020","4","130","39","169","76.923076923076920","23.0769230769230770","HOMEM"
"250150005000021","5","0","0","0",NULL,NULL,NULL
"250150010000001","1","174","52","226","76.991150442477870","23.0088495575221220","HOMEM"
"250150010000002","8","93","32","125","74.400000000000000","25.6000000000000000","HOMEM"
"250150010000003","8","133","23","156","85.256410256410260","14.7435897435897430","HOMEM"
"250150010000004","8","142","21","163","87.116564417177910","12.8834355828220860","HOMEM"
"250150010000005","8","76","51","127","59.842519685039370","40.1574803149606300","HOMEM"
"250150010000006","8","73","11","84","86.904761904761900","13.0952380952380950","HOMEM"
"250150010000007","8","90","13","103","87.378640776699030","12.6213592233009700","HOMEM"
"250150010000008","8","26","20","46","56.521739130434780","43.4782608695652200","HOMEM"
"250150010000009","5","79","36","115","68.695652173913050","31.3043478260869570","HOMEM"
"250150010000010","5","192","55","247","77.732793522267200","22.2672064777327920","HOMEM"
"250150010000011","8","60","14","74","81.081081081081080","18.9189189189189200","HOMEM"
"250150020000001","1","171","58","229","74.672489082969430","25.3275109170305700","HOMEM"
"250150020000002","8","44","25","69","63.768115942028984","36.2318840579710160","HOMEM"
"250150020000003","8","90","20","110","81.818181818181810","18.1818181818181830","HOMEM"
"250150020000004","8","82","17","99","82.828282828282820","17.1717171717171730","HOMEM"
"250150020000005","8","14","13","27","51.851851851851855","48.1481481481481450","HOMEM"
"250150020000006","8","226","55","281","80.427046263345190","19.5729537366548030","HOMEM"
"250150020000007","8","64","12","76","84.210526315789480","15.7894736842105260","HOMEM"
"250150020000008","8","116","17","133","87.218045112781950","12.7819548872180460","HOMEM"
"250150020000009","1","93","27","120","77.500000000000000","22.5000000000000000","HOMEM"
"250150020000010","5","41","17","58","70.689655172413800","29.3103448275862060","HOMEM"
"250153405000001","1","128","119","247","51.821862348178136","48.1781376518218640","HOMEM"
"250153405000002","1","96","107","203","47.290640394088670","52.7093596059113300","MULHER"
"250153405000003","8","72","129","201","35.820895522388060","64.1791044776119400","MULHER"
"250153405000004","8","56","35","91","61.538461538461540","38.4615384615384600","HOMEM"
"250153405000005","1","189","148","337","56.083086053412465","43.9169139465875350","HOMEM"
"250153405000006","1","121","100","221","54.751131221719454","45.2488687782805460","HOMEM"
"250157505000001","1","139","106","245","56.734693877551024","43.2653061224489760","HOMEM"
"250157505000002","8","138","43","181","76.243093922651940","23.7569060773480660","HOMEM"
"250157505000003","8","138","33","171","80.701754385964920","19.2982456140350900","HOMEM"
"250157505000004","8","147","54","201","73.134328358208960","26.8656716417910460","HOMEM"
"250157505000005","8","64","39","103","62.135922330097090","37.8640776699029100","HOMEM"
"250157505000006","8","103","23","126","81.746031746031750","18.2539682539682530","HOMEM"
"250157505000007","8","94","29","123","76.422764227642280","23.5772357723577240","HOMEM"
"250157505000008","8","167","50","217","76.958525345622120","23.0414746543778800","HOMEM"
"250157505000009","8","93","23","116","80.172413793103440","19.8275862068965500","HOMEM"
"250157505000010","8","91","23","114","79.824561403508770","20.1754385964912300","HOMEM"
"250157505000011","8","150","32","182","82.417582417582420","17.5824175824175840","HOMEM"
"250157505000012","8","85","67","152","55.921052631578945","44.0789473684210550","HOMEM"
"250157505000013","5","102","61","163","62.576687116564415","37.4233128834355850","HOMEM"
"250157505000014","5","111","43","154","72.077922077922080","27.9220779220779200","HOMEM"
"250157505000015","4","0","0","0",NULL,NULL,NULL
"250157505000016","5","34","23","57","59.649122807017540","40.3508771929824600","HOMEM"
"250157505000017","5","50","21","71","70.422535211267600","29.5774647887323960","HOMEM"
"250157505000018","5","0","0","0",NULL,NULL,NULL
"250160905000001","1","126","77","203","62.068965517241380","37.9310344827586200","HOMEM"
"250160905000002","1","43","90","133","32.330827067669176","67.6691729323308200","MULHER"
"250160905000003","1","70","111","181","38.674033149171270","61.3259668508287300","MULHER"
"250160905000004","1","145","101","246","58.943089430894310","41.0569105691056900","HOMEM"
"250160905000005","1","120","68","188","63.829787234042556","36.1702127659574440","HOMEM"
"250160905000006","1","87","55","142","61.267605633802816","38.7323943661971840","HOMEM"
"250160905000007","1","84","180","264","31.818181818181817","68.1818181818181900","MULHER"
"250160905000008","1","36","148","184","19.565217391304348","80.4347826086956600","MULHER"
"250160905000009","8","75","63","138","54.347826086956520","45.6521739130434800","HOMEM"
"250160905000010","8","207","80","287","72.125435540069690","27.8745644599303120","HOMEM"
"250160905000011","8","202","96","298","67.785234899328860","32.2147651006711440","HOMEM"
"250160905000012","8","83","113","196","42.346938775510200","57.6530612244898000","MULHER"
"250160905000013","8","84","14","98","85.714285714285710","14.2857142857142860","HOMEM"
"250160905000014","8","175","49","224","78.125000000000000","21.8750000000000000","HOMEM"
"250160905000015","8","131","12","143","91.608391608391610","8.3916083916083920","HOMEM"
"250160905000016","8","159","25","184","86.413043478260870","13.5869565217391300","HOMEM"
"250160905000017","5","61","6","67","91.044776119402980","8.9552238805970140","HOMEM"
"250160905000018","5","25","7","32","78.125000000000000","21.8750000000000000","HOMEM"
"250160905000019","1","126","81","207","60.869565217391305","39.1304347826086950","HOMEM"
"250160905000020","1","90","60","150","60.000000000000000","40.0000000000000000","HOMEM"
"250160905000021","1","33","33","66","50.000000000000000","50.0000000000000000","IGUAL"
"250160905000022","1","105","74","179","58.659217877094974","41.3407821229050260","HOMEM"
"250160905000023","1","101","92","193","52.331606217616580","47.6683937823834200","HOMEM"
"250160905000024","1","42","45","87","48.275862068965516","51.7241379310344840","MULHER"
"250160905000025","1","67","34","101","66.336633663366340","33.6633663366336650","HOMEM"
"250170805000001","1","103","47","150","68.666666666666670","31.3333333333333320","HOMEM"
"250170805000002","1","108","56","164","65.853658536585370","34.1463414634146360","HOMEM"
"250170805000003","8","97","25","122","79.508196721311480","20.4918032786885260","HOMEM"
"250170805000004","8","100","23","123","81.300813008130080","18.6991869918699200","HOMEM"
"250170805000005","8","117","24","141","82.978723404255320","17.0212765957446800","HOMEM"
"250170805000006","8","209","54","263","79.467680608365010","20.5323193916349800","HOMEM"
"250170805000007","5","51","3","54","94.444444444444440","5.5555555555555550","HOMEM"
"250170805000008","5","112","86","198","56.565656565656570","43.4343434343434300","HOMEM"
"250170805000009","1","120","49","169","71.005917159763310","28.9940828402366860","HOMEM"
"250170805000010","1","188","61","249","75.502008032128510","24.4979919678714850","HOMEM"
"250180705000001","1","44","21","65","67.692307692307700","32.3076923076923100","HOMEM"
"250180705000002","1","189","93","282","67.021276595744680","32.9787234042553200","HOMEM"
"250180705000003","1","92","91","183","50.273224043715850","49.7267759562841500","HOMEM"
"250180705000004","1","151","75","226","66.814159292035400","33.1858407079646000","HOMEM"
"250180705000005","1","103","110","213","48.356807511737090","51.6431924882629100","MULHER"
"250180705000006","1","143","148","291","49.140893470790380","50.8591065292096200","MULHER"
"250180705000007","1","114","106","220","51.818181818181820","48.1818181818181800","HOMEM"
"250180705000008","1","87","63","150","58.000000000000000","42.0000000000000000","HOMEM"
"250180705000009","1","164","86","250","65.600000000000000","34.4000000000000000","HOMEM"
"250180705000010","1","200","107","307","65.146579804560260","34.8534201954397400","HOMEM"
"250180705000011","1","110","105","215","51.162790697674420","48.8372093023255800","HOMEM"
"250180705000012","1","243","176","419","57.995226730310264","42.0047732696897360","HOMEM"
"250180705000013","1","213","157","370","57.567567567567565","42.4324324324324350","HOMEM"
"250180705000014","1","129","112","241","53.526970954356850","46.4730290456431500","HOMEM"
"250180705000015","1","204","118","322","63.354037267080750","36.6459627329192500","HOMEM"
"250180705000016","1","152","88","240","63.333333333333336","36.6666666666666640","HOMEM"
"250180705000017","1","185","119","304","60.855263157894740","39.1447368421052600","HOMEM"
"250180705000018","1","198","118","316","62.658227848101270","37.3417721518987300","HOMEM"
"250180705000019","1","193","119","312","61.858974358974360","38.1410256410256400","HOMEM"
"250180705000020","1","84","66","150","56.000000000000000","44.0000000000000000","HOMEM"
"250180705000021","1","85","116","201","42.288557213930346","57.7114427860696540","MULHER"
"250180705000022","1","225","129","354","63.559322033898304","36.4406779661016960","HOMEM"
"250180705000023","1","128","104","232","55.172413793103445","44.8275862068965550","HOMEM"
"250180705000024","1","159","130","289","55.017301038062286","44.9826989619377140","HOMEM"
"250180705000025","1","192","148","340","56.470588235294116","43.5294117647058840","HOMEM"
"250180705000026","1","101","159","260","38.846153846153850","61.1538461538461500","MULHER"
"250180705000027","1","122","104","226","53.982300884955755","46.0176991150442450","HOMEM"
"250180705000028","1","219","139","358","61.173184357541900","38.8268156424581000","HOMEM"
"250180705000029","1","175","105","280","62.500000000000000","37.5000000000000000","HOMEM"
"250180705000030","1","218","108","326","66.871165644171780","33.1288343558282200","HOMEM"
"250180705000031","1","191","142","333","57.357357357357360","42.6426426426426400","HOMEM"
"250180705000032","1","202","101","303","66.666666666666670","33.3333333333333360","HOMEM"
"250180705000033","1","147","85","232","63.362068965517240","36.6379310344827600","HOMEM"
"250180705000034","1","215","158","373","57.640750670241290","42.3592493297587100","HOMEM"
"250180705000035","1","121","58","179","67.597765363128490","32.4022346368715050","HOMEM"
"250180705000036","1","188","114","302","62.251655629139070","37.7483443708609300","HOMEM"
"250180705000037","1","40","31","71","56.338028169014090","43.6619718309859100","HOMEM"
"250180705000038","1","76","110","186","40.860215053763440","59.1397849462365600","MULHER"
"250180705000039","1","103","99","202","50.990099009900990","49.0099009900990100","HOMEM"
"250180705000040","1","53","46","99","53.535353535353536","46.4646464646464640","HOMEM"
"250180705000041","1","186","132","318","58.490566037735846","41.5094339622641540","HOMEM"
"250180705000042","1","141","96","237","59.493670886075950","40.5063291139240500","HOMEM"
"250180705000043","1","65","113","178","36.516853932584270","63.4831460674157300","MULHER"
"250180705000044","1","99","113","212","46.698113207547166","53.3018867924528340","MULHER"
"250180705000045","1","167","85","252","66.269841269841270","33.7301587301587300","HOMEM"
"250180705000046","1","68","180","248","27.419354838709676","72.5806451612903200","MULHER"
"250180705000047","1","83","211","294","28.231292517006803","71.7687074829932000","MULHER"
"250180705000048","1","46","16","62","74.193548387096770","25.8064516129032240","HOMEM"
"250180705000049","1","263","87","350","75.142857142857140","24.8571428571428580","HOMEM"
"250180705000050","1","156","51","207","75.362318840579700","24.6376811594202900","HOMEM"
"250180705000051","1","162","71","233","69.527896995708160","30.4721030042918460","HOMEM"
"250180705000052","1","126","68","194","64.948453608247420","35.0515463917525800","HOMEM"
"250180705000053","1","190","82","272","69.852941176470600","30.1470588235294130","HOMEM"
"250180705000054","1","120","88","208","57.692307692307690","42.3076923076923100","HOMEM"
"250180705000055","1","104","131","235","44.255319148936174","55.7446808510638260","MULHER"
"250180705000056","1","142","117","259","54.826254826254825","45.1737451737451750","HOMEM"
"250180705000057","1","95","71","166","57.228915662650600","42.7710843373494000","HOMEM"
"250180705000058","1","146","127","273","53.479853479853480","46.5201465201465200","HOMEM"
"250180705000059","1","168","133","301","55.813953488372090","44.1860465116279100","HOMEM"
"250180705000060","1","143","112","255","56.078431372549020","43.9215686274509800","HOMEM"
"250180705000061","1","99","188","287","34.494773519163765","65.5052264808362400","MULHER"
"250180705000062","1","161","118","279","57.706093189964160","42.2939068100358400","HOMEM"
"250180705000063","1","121","48","169","71.597633136094670","28.4023668639053250","HOMEM"
"250180705000065","1","114","72","186","61.290322580645160","38.7096774193548400","HOMEM"
"250180705000066","1","67","148","215","31.162790697674417","68.8372093023255800","MULHER"
"250180705000067","1","113","80","193","58.549222797927460","41.4507772020725400","HOMEM"
"250180705000068","1","173","128","301","57.475083056478404","42.5249169435215960","HOMEM"
"250180705000069","1","141","89","230","61.304347826086950","38.6956521739130500","HOMEM"
"250180705000070","1","207","122","329","62.917933130699090","37.0820668693009100","HOMEM"
"250180705000071","1","158","158","316","50.000000000000000","50.0000000000000000","IGUAL"
"250180705000072","1","155","96","251","61.752988047808760","38.2470119521912400","HOMEM"
"250180705000073","1","105","88","193","54.404145077720210","45.5958549222797900","HOMEM"
"250180705000074","1","119","128","247","48.178137651821864","51.8218623481781360","MULHER"
"250180705000075","1","58","78","136","42.647058823529410","57.3529411764705900","MULHER"
"250180705000076","1","59","27","86","68.604651162790700","31.3953488372093000","HOMEM"
"250180705000077","1","109","53","162","67.283950617283950","32.7160493827160500","HOMEM"
"250180705000078","1","133","57","190","70.000000000000000","30.0000000000000000","HOMEM"
"250180705000079","1","105","128","233","45.064377682403430","54.9356223175965700","MULHER"
"250180705000080","1","102","76","178","57.303370786516850","42.6966292134831500","HOMEM"
"250180705000081","1","6","5","11","54.545454545454550","45.4545454545454500","HOMEM"
"250180705000082","1","85","63","148","57.432432432432435","42.5675675675675650","HOMEM"
"250180705000083","1","3","4","7","42.857142857142854","57.1428571428571460","MULHER"
"250180705000085","1","65","143","208","31.250000000000000","68.7500000000000000","MULHER"
"250180705000086","1","47","31","78","60.256410256410255","39.7435897435897450","HOMEM"
"250180705000087","1","18","37","55","32.727272727272730","67.2727272727272700","MULHER"
"250180705000088","1","32","129","161","19.875776397515526","80.1242236024844800","MULHER"
"250180705000089","1","129","98","227","56.828193832599120","43.1718061674008800","HOMEM"
"250180705000091","1","99","77","176","56.250000000000000","43.7500000000000000","HOMEM"
"250180705000092","8","164","85","249","65.863453815261040","34.1365461847389540","HOMEM"
"250180705000094","1","113","67","180","62.777777777777780","37.2222222222222200","HOMEM"
"250180705000095","1","88","29","117","75.213675213675220","24.7863247863247870","HOMEM"
"250180705000096","1","39","87","126","30.952380952380953","69.0476190476190500","MULHER"
"250180705000097","1","66","29","95","69.473684210526320","30.5263157894736850","HOMEM"
"250180705000098","1","189","77","266","71.052631578947370","28.9473684210526300","HOMEM"
"250180705000099","1","53","141","194","27.319587628865980","72.6804123711340300","MULHER"
"250180705000100","1","100","61","161","62.111801242236030","37.8881987577639700","HOMEM"
"250180705000101","1","144","83","227","63.436123348017624","36.5638766519823760","HOMEM"
"250180705000102","1","160","86","246","65.040650406504070","34.9593495934959360","HOMEM"
"250180705000103","1","116","89","205","56.585365853658540","43.4146341463414600","HOMEM"
"250180705000104","1","128","52","180","71.111111111111110","28.8888888888888900","HOMEM"
"250180705000105","1","45","4","49","91.836734693877550","8.1632653061224500","HOMEM"
"250180705000106","1","167","32","199","83.919597989949750","16.0804020100502500","HOMEM"
"250180705000107","1","229","37","266","86.090225563909770","13.9097744360902260","HOMEM"
"250180705000108","1","123","38","161","76.397515527950300","23.6024844720496900","HOMEM"
"250180705000109","1","107","77","184","58.152173913043480","41.8478260869565200","HOMEM"
"250180705000110","1","136","67","203","66.995073891625620","33.0049261083743840","HOMEM"
"250180705000111","1","98","60","158","62.025316455696200","37.9746835443038000","HOMEM"
"250180705000112","1","106","82","188","56.382978723404260","43.6170212765957400","HOMEM"
"250180705000113","1","47","92","139","33.812949640287770","66.1870503597122300","MULHER"
"250180705000114","1","75","66","141","53.191489361702125","46.8085106382978750","HOMEM"
"250180705000115","1","125","76","201","62.189054726368160","37.8109452736318400","HOMEM"
"250180705000116","1","81","76","157","51.592356687898090","48.4076433121019100","HOMEM"
"250180705000117","1","91","63","154","59.090909090909090","40.9090909090909100","HOMEM"
"250180705000118","1","41","46","87","47.126436781609190","52.8735632183908100","MULHER"
"250180705000119","1","151","41","192","78.645833333333330","21.3541666666666680","HOMEM"
"250180705000120","1","193","127","320","60.312500000000000","39.6875000000000000","HOMEM"
"250180705000121","1","222","120","342","64.912280701754380","35.0877192982456200","HOMEM"
"250180705000122","1","116","94","210","55.238095238095240","44.7619047619047600","HOMEM"
"250180705000123","1","151","62","213","70.892018779342720","29.1079812206572760","HOMEM"
"250180705000124","1","125","37","162","77.160493827160500","22.8395061728395060","HOMEM"
"250180705000125","1","108","55","163","66.257668711656440","33.7423312883435600","HOMEM"
"250180705000126","1","216","110","326","66.257668711656440","33.7423312883435600","HOMEM"
"250180705000127","1","167","82","249","67.068273092369480","32.9317269076305200","HOMEM"
"250180705000128","1","404","169","573","70.506108202443290","29.4938917975567200","HOMEM"
"250180705000129","1","150","50","200","75.000000000000000","25.0000000000000000","HOMEM"
"250180705000130","1","24","13","37","64.864864864864870","35.1351351351351400","HOMEM"
"250180705000131","1","7","1","8","87.500000000000000","12.5000000000000000","HOMEM"
"250180705000132","1","63","27","90","70.000000000000000","30.0000000000000000","HOMEM"
"250180705000133","1","57","18","75","76.000000000000000","24.0000000000000000","HOMEM"
"250180705000134","1","10","3","13","76.923076923076920","23.0769230769230770","HOMEM"
"250190605000001","1","150","74","224","66.964285714285710","33.0357142857142850","HOMEM"
"250190605000002","1","130","107","237","54.852320675105490","45.1476793248945100","HOMEM"
"250190605000003","1","182","131","313","58.146964856230035","41.8530351437699650","HOMEM"
"250190605000004","1","141","79","220","64.090909090909100","35.9090909090909100","HOMEM"
"250190605000005","1","123","59","182","67.582417582417580","32.4175824175824160","HOMEM"
"250190605000006","1","190","109","299","63.545150501672240","36.4548494983277600","HOMEM"
"250190605000007","1","153","107","260","58.846153846153850","41.1538461538461500","HOMEM"
"250190605000008","1","189","84","273","69.230769230769230","30.7692307692307700","HOMEM"
"250190605000009","1","161","116","277","58.122743682310470","41.8772563176895300","HOMEM"
"250190605000010","1","171","98","269","63.568773234200740","36.4312267657992600","HOMEM"
"250190605000011","1","115","47","162","70.987654320987660","29.0123456790123450","HOMEM"
"250190605000012","1","194","139","333","58.258258258258260","41.7417417417417400","HOMEM"
"250190605000013","1","183","120","303","60.396039603960396","39.6039603960396040","HOMEM"
"250190605000014","8","143","28","171","83.625730994152050","16.3742690058479530","HOMEM"
"250190605000015","8","63","9","72","87.500000000000000","12.5000000000000000","HOMEM"
"250190605000016","8","63","19","82","76.829268292682930","23.1707317073170740","HOMEM"
"250190605000017","8","104","92","196","53.061224489795920","46.9387755102040800","HOMEM"
"250190605000018","1","58","66","124","46.774193548387096","53.2258064516129040","MULHER"
"250190605000019","1","119","88","207","57.487922705314010","42.5120772946859900","HOMEM"
"250190605000020","1","86","46","132","65.151515151515160","34.8484848484848500","HOMEM"
"250190610000001","1","177","95","272","65.073529411764710","34.9264705882353000","HOMEM"
"250190610000002","8","144","57","201","71.641791044776110","28.3582089552238800","HOMEM"
"250190610000003","8","65","14","79","82.278481012658230","17.7215189873417700","HOMEM"
"250190610000004","1","169","93","262","64.503816793893140","35.4961832061068700","HOMEM"
"250200305000001","1","192","104","296","64.864864864864870","35.1351351351351400","HOMEM"
"250200305000002","1","108","77","185","58.378378378378380","41.6216216216216200","HOMEM"
"250200305000003","1","65","132","197","32.994923857868024","67.0050761421319800","MULHER"
"250200305000004","1","156","87","243","64.197530864197530","35.8024691358024700","HOMEM"
"250200305000005","8","16","4","20","80.000000000000000","20.0000000000000000","HOMEM"
"250200305000006","8","29","9","38","76.315789473684200","23.6842105263157900","HOMEM"
"250200305000007","8","62","6","68","91.176470588235290","8.8235294117647070","HOMEM"
"250200305000008","8","88","19","107","82.242990654205610","17.7570093457943940","HOMEM"
"250200305000009","8","69","23","92","75.000000000000000","25.0000000000000000","HOMEM"
"250200305000010","8","19","14","33","57.575757575757580","42.4242424242424200","HOMEM"
"250200305000011","8","17","24","41","41.463414634146340","58.5365853658536600","MULHER"
"250200305000012","8","22","23","45","48.888888888888886","51.1111111111111140","MULHER"
"250200305000013","8","34","19","53","64.150943396226410","35.8490566037735800","HOMEM"
"250200305000014","1","138","91","229","60.262008733624455","39.7379912663755450","HOMEM"
"250200305000015","1","56","76","132","42.424242424242420","57.5757575757575800","MULHER"
"250200305000016","1","51","136","187","27.272727272727273","72.7272727272727300","MULHER"
"250205205000001","1","168","79","247","68.016194331983810","31.9838056680161960","HOMEM"
"250205205000002","8","142","57","199","71.356783919597990","28.6432160804020100","HOMEM"
"250205205000003","8","127","27","154","82.467532467532460","17.5324675324675320","HOMEM"
"250205205000004","5","87","13","100","87.000000000000000","13.0000000000000000","HOMEM"
"250205205000005","5","75","24","99","75.757575757575750","24.2424242424242420","HOMEM"
"250210205000001","1","244","115","359","67.966573816155990","32.0334261838440140","HOMEM"
"250210205000002","1","182","128","310","58.709677419354840","41.2903225806451600","HOMEM"
"250210205000003","1","234","78","312","75.000000000000000","25.0000000000000000","HOMEM"
"250210205000004","8","162","24","186","87.096774193548380","12.9032258064516120","HOMEM"
"250210205000005","8","143","22","165","86.666666666666670","13.3333333333333340","HOMEM"
"250210205000006","8","103","9","112","91.964285714285710","8.0357142857142860","HOMEM"
"250210205000007","8","27","3","30","90.000000000000000","10.0000000000000000","HOMEM"
"250210205000008","5","13","5","18","72.222222222222230","27.7777777777777800","HOMEM"
"250215105000001","1","144","87","231","62.337662337662340","37.6623376623376600","HOMEM"
"250215105000002","1","141","61","202","69.801980198019800","30.1980198019801980","HOMEM"
"250215105000003","8","152","28","180","84.444444444444440","15.5555555555555550","HOMEM"
"250215105000004","8","217","43","260","83.461538461538470","16.5384615384615400","HOMEM"
"250215105000005","8","120","23","143","83.916083916083920","16.0839160839160830","HOMEM"
"250215105000006","8","111","34","145","76.551724137931030","23.4482758620689640","HOMEM"
"250215105000007","1","169","84","253","66.798418972332020","33.2015810276679840","HOMEM"
"250215105000008","1","166","56","222","74.774774774774770","25.2252252252252270","HOMEM"
"250215105000009","4","76","18","94","80.851063829787240","19.1489361702127670","HOMEM"
"250220105000001","1","199","106","305","65.245901639344270","34.7540983606557400","HOMEM"
"250220105000002","8","87","19","106","82.075471698113200","17.9245283018867900","HOMEM"
"250220105000003","8","81","17","98","82.653061224489790","17.3469387755102030","HOMEM"
"250220105000004","5","117","73","190","61.578947368421055","38.4210526315789450","HOMEM"
"250230005000001","1","142","62","204","69.607843137254900","30.3921568627450970","HOMEM"
"250230005000002","1","171","64","235","72.765957446808510","27.2340425531914900","HOMEM"
"250230005000003","8","32","11","43","74.418604651162800","25.5813953488372100","HOMEM"
"250230005000004","8","77","13","90","85.555555555555560","14.4444444444444450","HOMEM"
"250230005000005","8","81","22","103","78.640776699029130","21.3592233009708750","HOMEM"
"250230005000006","5","78","31","109","71.559633027522930","28.4403669724770650","HOMEM"
"250230005000007","8","97","20","117","82.905982905982910","17.0940170940170940","HOMEM"
"250230005000008","8","56","11","67","83.582089552238810","16.4179104477611940","HOMEM"
"250230005000009","8","162","27","189","85.714285714285710","14.2857142857142860","HOMEM"
"250230005000010","8","130","22","152","85.526315789473680","14.4736842105263150","HOMEM"
"250230005000011","1","120","84","204","58.823529411764700","41.1764705882353000","HOMEM"
"250240905000001","1","152","90","242","62.809917355371900","37.1900826446281000","HOMEM"
"250240905000002","1","187","155","342","54.678362573099410","45.3216374269005900","HOMEM"
"250240905000003","1","140","98","238","58.823529411764700","41.1764705882353000","HOMEM"
"250240905000004","1","161","49","210","76.666666666666670","23.3333333333333320","HOMEM"
"250240905000005","1","239","114","353","67.705382436260620","32.2946175637393800","HOMEM"
"250240905000006","8","150","16","166","90.361445783132520","9.6385542168674700","HOMEM"
"250240905000007","8","60","13","73","82.191780821917800","17.8082191780821900","HOMEM"
"250240905000008","8","78","7","85","91.764705882352940","8.2352941176470580","HOMEM"
"250240905000009","8","79","11","90","87.777777777777770","12.2222222222222210","HOMEM"
"250240905000010","8","98","14","112","87.500000000000000","12.5000000000000000","HOMEM"
"250240905000011","1","171","57","228","75.000000000000000","25.0000000000000000","HOMEM"
"250240905000012","1","122","81","203","60.098522167487690","39.9014778325123100","HOMEM"
"250240930000001","1","154","42","196","78.571428571428570","21.4285714285714270","HOMEM"
"250240930000002","8","137","13","150","91.333333333333330","8.6666666666666660","HOMEM"
"250240930000003","8","95","18","113","84.070796460177000","15.9292035398230090","HOMEM"
"250250805000001","1","123","126","249","49.397590361445786","50.6024096385542140","MULHER"
"250250805000002","1","127","142","269","47.211895910780670","52.7881040892193300","MULHER"
"250250805000003","1","93","61","154","60.389610389610390","39.6103896103896100","HOMEM"
"250250805000004","1","113","100","213","53.051643192488264","46.9483568075117360","HOMEM"
"250250805000005","1","118","107","225","52.444444444444440","47.5555555555555600","HOMEM"
"250250805000006","1","207","104","311","66.559485530546620","33.4405144694533760","HOMEM"
"250250805000007","1","119","95","214","55.607476635514020","44.3925233644859800","HOMEM"
"250250805000008","1","164","129","293","55.972696245733786","44.0273037542662140","HOMEM"
"250250805000009","1","156","127","283","55.123674911660780","44.8763250883392200","HOMEM"
"250250805000010","1","185","118","303","61.056105610561055","38.9438943894389450","HOMEM"
"250250805000011","1","189","127","316","59.810126582278480","40.1898734177215200","HOMEM"
"250250805000012","1","121","65","186","65.053763440860210","34.9462365591397840","HOMEM"
"250250805000013","8","201","52","253","79.446640316205530","20.5533596837944650","HOMEM"
"250250805000014","8","141","30","171","82.456140350877190","17.5438596491228100","HOMEM"
"250250805000015","8","82","24","106","77.358490566037730","22.6415094339622630","HOMEM"
"250250805000016","8","195","29","224","87.053571428571430","12.9464285714285710","HOMEM"
"250250805000017","8","83","17","100","83.000000000000000","17.0000000000000000","HOMEM"
"250250805000018","8","81","28","109","74.311926605504580","25.6880733944954100","HOMEM"
"250250805000019","1","140","67","207","67.632850241545900","32.3671497584541040","HOMEM"
"250250805000020","1","85","71","156","54.487179487179490","45.5128205128205100","HOMEM"
"250250805000021","4","27","14","41","65.853658536585370","34.1463414634146360","HOMEM"
"250250805000022","5","31","27","58","53.448275862068970","46.5517241379310300","HOMEM"
"250250805000023","5","42","23","65","64.615384615384610","35.3846153846153900","HOMEM"
"250250830000001","1","110","44","154","71.428571428571430","28.5714285714285730","HOMEM"
"250250830000002","8","50","21","71","70.422535211267600","29.5774647887323960","HOMEM"
"250250830000003","8","36","41","77","46.753246753246756","53.2467532467532440","MULHER"
"250250830000004","5","35","10","45","77.777777777777770","22.2222222222222200","HOMEM"
"250260705000001","1","235","80","315","74.603174603174610","25.3968253968253950","HOMEM"
"250260705000002","1","168","71","239","70.292887029288700","29.7071129707112970","HOMEM"
"250260705000003","1","196","96","292","67.123287671232870","32.8767123287671300","HOMEM"
"250260705000004","1","231","127","358","64.525139664804470","35.4748603351955300","HOMEM"
"250260705000005","8","40","4","44","90.909090909090900","9.0909090909090920","HOMEM"
"250260705000006","8","106","14","120","88.333333333333330","11.6666666666666660","HOMEM"
"250260705000007","8","111","18","129","86.046511627906980","13.9534883720930230","HOMEM"
"250260705000008","8","57","18","75","76.000000000000000","24.0000000000000000","HOMEM"
"250260705000009","8","51","8","59","86.440677966101690","13.5593220338983040","HOMEM"
"250260705000010","8","25","3","28","89.285714285714290","10.7142857142857140","HOMEM"
"250260705000011","8","57","14","71","80.281690140845070","19.7183098591549280","HOMEM"
"250270605000001","1","179","110","289","61.937716262975776","38.0622837370242240","HOMEM"
"250270605000002","1","156","108","264","59.090909090909090","40.9090909090909100","HOMEM"
"250270605000003","1","108","79","187","57.754010695187170","42.2459893048128300","HOMEM"
"250270605000004","8","121","39","160","75.625000000000000","24.3750000000000000","HOMEM"
"250270605000005","8","74","15","89","83.146067415730340","16.8539325842696640","HOMEM"
"250270605000006","8","67","16","83","80.722891566265060","19.2771084337349400","HOMEM"
"250270605000007","8","18","2","20","90.000000000000000","10.0000000000000000","HOMEM"
"250270605000008","1","212","91","303","69.966996699669960","30.0330033003300340","HOMEM"
"250280505000001","1","118","69","187","63.101604278074866","36.8983957219251340","HOMEM"
"250280505000002","1","125","99","224","55.803571428571430","44.1964285714285700","HOMEM"
"250280505000003","1","54","47","101","53.465346534653460","46.5346534653465400","HOMEM"
"250280505000004","1","211","144","355","59.436619718309856","40.5633802816901440","HOMEM"
"250280505000005","1","110","75","185","59.459459459459460","40.5405405405405400","HOMEM"
"250280505000006","1","98","68","166","59.036144578313255","40.9638554216867450","HOMEM"
"250280505000007","1","139","146","285","48.771929824561404","51.2280701754385960","MULHER"
"250280505000008","1","122","68","190","64.210526315789480","35.7894736842105300","HOMEM"
"250280505000009","1","214","119","333","64.264264264264270","35.7357357357357400","HOMEM"
"250280505000010","8","66","27","93","70.967741935483870","29.0322580645161280","HOMEM"
"250280505000011","8","47","21","68","69.117647058823540","30.8823529411764700","HOMEM"
"250280505000012","8","174","21","195","89.230769230769230","10.7692307692307700","HOMEM"
"250280505000013","8","92","11","103","89.320388349514560","10.6796116504854370","HOMEM"
"250280505000014","8","80","12","92","86.956521739130440","13.0434782608695650","HOMEM"
"250280505000015","8","105","28","133","78.947368421052630","21.0526315789473700","HOMEM"
"250280505000016","8","130","27","157","82.802547770700640","17.1974522292993620","HOMEM"
"250280505000017","1","86","71","157","54.777070063694270","45.2229299363057300","HOMEM"
"250280505000018","1","118","76","194","60.824742268041234","39.1752577319587660","HOMEM"
"250280505000019","1","139","100","239","58.158995815899580","41.8410041841004200","HOMEM"
"250280505000020","1","116","56","172","67.441860465116280","32.5581395348837200","HOMEM"
"250290405000001","1","94","43","137","68.613138686131390","31.3868613138686140","HOMEM"
"250290405000002","1","158","66","224","70.535714285714290","29.4642857142857150","HOMEM"
"250290405000003","1","149","86","235","63.404255319148940","36.5957446808510600","HOMEM"
"250290405000004","1","260","92","352","73.863636363636360","26.1363636363636370","HOMEM"
"250290405000005","8","72","25","97","74.226804123711350","25.7731958762886600","HOMEM"
"250290405000006","8","82","8","90","91.111111111111110","8.8888888888888900","HOMEM"
"250290405000007","8","72","13","85","84.705882352941170","15.2941176470588240","HOMEM"
"250290405000008","8","104","49","153","67.973856209150330","32.0261437908496700","HOMEM"
"250290405000009","1","192","76","268","71.641791044776110","28.3582089552238800","HOMEM"
"250290405000010","1","86","99","185","46.486486486486484","53.5135135135135160","MULHER"
"250300105000001","1","155","87","242","64.049586776859500","35.9504132231404940","HOMEM"
"250300105000002","1","234","108","342","68.421052631578950","31.5789473684210500","HOMEM"
"250300105000003","1","196","87","283","69.257950530035330","30.7420494699646660","HOMEM"
"250300105000004","1","177","88","265","66.792452830188680","33.2075471698113200","HOMEM"
"250300105000005","1","164","97","261","62.835249042145590","37.1647509578544100","HOMEM"
"250300105000006","1","150","73","223","67.264573991031380","32.7354260089686100","HOMEM"
"250300105000007","1","194","174","368","52.717391304347830","47.2826086956521700","HOMEM"
"250300105000008","1","114","64","178","64.044943820224720","35.9550561797752800","HOMEM"
"250300105000009","1","180","87","267","67.415730337078660","32.5842696629213500","HOMEM"
"250300105000010","1","116","55","171","67.836257309941520","32.1637426900584800","HOMEM"
"250300105000011","8","59","9","68","86.764705882352940","13.2352941176470580","HOMEM"
"250300105000012","8","106","29","135","78.518518518518520","21.4814814814814800","HOMEM"
"250300105000013","8","156","26","182","85.714285714285710","14.2857142857142860","HOMEM"
"250300105000014","8","14","6","20","70.000000000000000","30.0000000000000000","HOMEM"
"250300105000015","1","137","78","215","63.720930232558140","36.2790697674418600","HOMEM"
"250300105000016","1","107","38","145","73.793103448275860","26.2068965517241400","HOMEM"
"250300105000017","1","165","81","246","67.073170731707320","32.9268292682926860","HOMEM"
"250300105000018","1","172","103","275","62.545454545454550","37.4545454545454500","HOMEM"
"250300105000019","1","144","76","220","65.454545454545450","34.5454545454545500","HOMEM"
"250300105000020","1","138","62","200","69.000000000000000","31.0000000000000000","HOMEM"
"250300115000001","1","238","135","373","63.806970509383376","36.1930294906166240","HOMEM"
"250300115000002","1","157","83","240","65.416666666666670","34.5833333333333360","HOMEM"
"250300115000003","8","120","40","160","75.000000000000000","25.0000000000000000","HOMEM"
"250300115000004","5","65","32","97","67.010309278350520","32.9896907216494800","HOMEM"
"250300115000005","8","17","4","21","80.952380952380950","19.0476190476190470","HOMEM"
"250300115000006","8","29","8","37","78.378378378378370","21.6216216216216200","HOMEM"
"250300115000007","1","148","61","209","70.813397129186600","29.1866028708134000","HOMEM"
"250310005000001","1","75","58","133","56.390977443609025","43.6090225563909750","HOMEM"
"250310005000002","1","125","90","215","58.139534883720930","41.8604651162790700","HOMEM"
"250310005000003","8","141","38","179","78.770949720670390","21.2290502793296100","HOMEM"
"250310005000004","8","64","12","76","84.210526315789480","15.7894736842105260","HOMEM"
"250310005000005","8","145","49","194","74.742268041237110","25.2577319587628860","HOMEM"
"250310005000006","5","36","23","59","61.016949152542374","38.9830508474576260","HOMEM"
"250310005000007","8","218","80","298","73.154362416107390","26.8456375838926180","HOMEM"
"250310005000008","1","95","56","151","62.913907284768214","37.0860927152317860","HOMEM"
"250310005000009","1","117","86","203","57.635467980295566","42.3645320197044340","HOMEM"
"250320905000001","1","179","146","325","55.076923076923080","44.9230769230769200","HOMEM"
"250320905000002","1","95","62","157","60.509554140127390","39.4904458598726100","HOMEM"
"250320905000003","1","123","85","208","59.134615384615390","40.8653846153846100","HOMEM"
"250320905000004","1","146","110","256","57.031250000000000","42.9687500000000000","HOMEM"
"250320905000005","1","136","88","224","60.714285714285715","39.2857142857142850","HOMEM"
"250320905000006","1","134","93","227","59.030837004405285","40.9691629955947150","HOMEM"
"250320905000007","1","177","147","324","54.629629629629626","45.3703703703703740","HOMEM"
"250320905000008","1","96","99","195","49.230769230769230","50.7692307692307700","MULHER"
"250320905000009","1","97","86","183","53.005464480874316","46.9945355191256840","HOMEM"
"250320905000010","1","118","264","382","30.890052356020940","69.1099476439790500","MULHER"
"250320905000011","1","86","99","185","46.486486486486484","53.5135135135135160","MULHER"
"250320905000012","1","89","181","270","32.962962962962960","67.0370370370370400","MULHER"
"250320905000013","1","52","118","170","30.588235294117650","69.4117647058823500","MULHER"
"250320905000014","1","127","136","263","48.288973384030420","51.7110266159695800","MULHER"
"250320905000015","1","67","3","70","95.714285714285710","4.2857142857142860","HOMEM"
"250320905000016","1","65","184","249","26.104417670682732","73.8955823293172600","MULHER"
"250320905000017","1","139","87","226","61.504424778761060","38.4955752212389400","HOMEM"
"250320905000018","1","29","7","36","80.555555555555560","19.4444444444444430","HOMEM"
"250320905000019","1","177","64","241","73.443983402489620","26.5560165975103750","HOMEM"
"250320905000020","1","82","53","135","60.740740740740740","39.2592592592592600","HOMEM"
"250320905000021","1","67","37","104","64.423076923076920","35.5769230769230800","HOMEM"
"250320905000022","1","111","44","155","71.612903225806450","28.3870967741935480","HOMEM"
"250320905000023","1","49","28","77","63.636363636363630","36.3636363636363700","HOMEM"
"250320905000024","1","79","56","135","58.518518518518520","41.4814814814814800","HOMEM"
"250320905000025","1","138","93","231","59.740259740259740","40.2597402597402600","HOMEM"
"250320905000026","1","89","148","237","37.552742616033754","62.4472573839662460","MULHER"
"250320905000027","1","78","53","131","59.541984732824424","40.4580152671755760","HOMEM"
"250320905000028","1","100","70","170","58.823529411764700","41.1764705882353000","HOMEM"
"250320905000029","1","95","55","150","63.333333333333336","36.6666666666666640","HOMEM"
"250320905000030","1","93","60","153","60.784313725490190","39.2156862745098100","HOMEM"
"250320905000031","1","90","66","156","57.692307692307690","42.3076923076923100","HOMEM"
"250320905000032","1","100","36","136","73.529411764705880","26.4705882352941160","HOMEM"
"250320905000033","1","173","102","275","62.909090909090910","37.0909090909090900","HOMEM"
"250320905000034","1","93","66","159","58.490566037735846","41.5094339622641540","HOMEM"
"250320905000035","1","87","37","124","70.161290322580640","29.8387096774193560","HOMEM"
"250320905000036","1","135","54","189","71.428571428571430","28.5714285714285730","HOMEM"
"250320905000037","1","246","98","344","71.511627906976740","28.4883720930232550","HOMEM"
"250320905000038","1","0","0","0",NULL,NULL,NULL
"250320905000039","8","0","0","0",NULL,NULL,NULL
"250320905000040","1","102","82","184","55.434782608695650","44.5652173913043500","HOMEM"
"250320905000041","1","130","80","210","61.904761904761905","38.0952380952380950","HOMEM"
"250320905000042","1","98","52","150","65.333333333333330","34.6666666666666640","HOMEM"
"250320905000043","1","102","106","208","49.038461538461540","50.9615384615384600","MULHER"
"250320905000044","1","78","86","164","47.560975609756100","52.4390243902439000","MULHER"
"250320905000045","1","113","123","236","47.881355932203390","52.1186440677966100","MULHER"
"250320905000046","1","110","59","169","65.088757396449710","34.9112426035503000","HOMEM"
"250320905000047","1","85","50","135","62.962962962962960","37.0370370370370400","HOMEM"
"250320905000048","1","92","119","211","43.601895734597160","56.3981042654028400","MULHER"
"250320905000049","1","100","73","173","57.803468208092480","42.1965317919075200","HOMEM"
"250320905000050","1","167","85","252","66.269841269841270","33.7301587301587300","HOMEM"
"250320905000051","1","43","27","70","61.428571428571430","38.5714285714285700","HOMEM"
"250320905000052","1","42","14","56","75.000000000000000","25.0000000000000000","HOMEM"
"250320905000053","1","142","108","250","56.800000000000000","43.2000000000000000","HOMEM"
"250320905000054","1","83","130","213","38.967136150234744","61.0328638497652560","MULHER"
"250320905000055","1","177","101","278","63.669064748201436","36.3309352517985640","HOMEM"
"250320905000056","1","170","91","261","65.134099616858240","34.8659003831417600","HOMEM"
"250320905000057","1","28","13","41","68.292682926829270","31.7073170731707300","HOMEM"
"250320905000058","1","56","23","79","70.886075949367080","29.1139240506329100","HOMEM"
"250320905000059","1","75","14","89","84.269662921348310","15.7303370786516850","HOMEM"
"250320905000060","1","45","30","75","60.000000000000000","40.0000000000000000","HOMEM"
"250320905000061","1","77","24","101","76.237623762376230","23.7623762376237620","HOMEM"
"250320905000062","1","149","134","283","52.650176678445230","47.3498233215547700","HOMEM"
"250320905000063","1","156","116","272","57.352941176470590","42.6470588235294100","HOMEM"
"250320905000064","1","159","36","195","81.538461538461530","18.4615384615384600","HOMEM"
"250320905000065","1","85","71","156","54.487179487179490","45.5128205128205100","HOMEM"
"250320905000066","1","161","80","241","66.804979253112040","33.1950207468879700","HOMEM"
"250320905000067","1","257","105","362","70.994475138121540","29.0055248618784520","HOMEM"
"250320905000068","1","143","133","276","51.811594202898550","48.1884057971014500","HOMEM"
"250320905000069","1","215","161","376","57.180851063829785","42.8191489361702150","HOMEM"
"250320905000070","1","307","216","523","58.699808795411090","41.3001912045889100","HOMEM"
"250320905000071","1","84","36","120","70.000000000000000","30.0000000000000000","HOMEM"
"250320905000072","1","73","31","104","70.192307692307700","29.8076923076923070","HOMEM"
"250320905000073","1","131","65","196","66.836734693877550","33.1632653061224500","HOMEM"
"250320905000074","1","97","43","140","69.285714285714290","30.7142857142857150","HOMEM"
"250320905000075","1","122","52","174","70.114942528735630","29.8850574712643680","HOMEM"
"250320905000076","1","121","48","169","71.597633136094670","28.4023668639053250","HOMEM"
"250320905000077","1","68","61","129","52.713178294573645","47.2868217054263550","HOMEM"
"250320905000078","1","65","59","124","52.419354838709680","47.5806451612903200","HOMEM"
"250320925000001","1","140","105","245","57.142857142857146","42.8571428571428540","HOMEM"
"250320925000002","1","155","196","351","44.159544159544160","55.8404558404558400","MULHER"
"250320925000003","1","101","106","207","48.792270531400966","51.2077294685990340","MULHER"
"250320925000004","1","122","79","201","60.696517412935320","39.3034825870646800","HOMEM"
"250320925000005","1","145","116","261","55.555555555555560","44.4444444444444400","HOMEM"
"250320925000006","1","140","168","308","45.454545454545450","54.5454545454545500","MULHER"
"250320925000007","1","230","94","324","70.987654320987660","29.0123456790123450","HOMEM"
"250320925000008","1","122","100","222","54.954954954954960","45.0450450450450400","HOMEM"
"250320925000009","1","101","165","266","37.969924812030070","62.0300751879699300","MULHER"
"250330805000001","1","184","86","270","68.148148148148150","31.8518518518518500","HOMEM"
"250330805000002","1","249","88","337","73.887240356083080","26.1127596439169130","HOMEM"
"250330805000003","8","92","37","129","71.317829457364340","28.6821705426356600","HOMEM"
"250330805000004","8","0","0","0",NULL,NULL,NULL
"250330805000005","8","91","39","130","70.000000000000000","30.0000000000000000","HOMEM"
"250330805000006","8","112","13","125","89.600000000000000","10.4000000000000000","HOMEM"
"250330805000007","1","177","73","250","70.800000000000000","29.2000000000000000","HOMEM"
"250330805000008","8","234","82","316","74.050632911392400","25.9493670886075950","HOMEM"
"250330805000009","8","126","44","170","74.117647058823540","25.8823529411764700","HOMEM"
"250330805000010","8","49","13","62","79.032258064516130","20.9677419354838720","HOMEM"
"250330805000011","8","0","0","0",NULL,NULL,NULL
"250330810000001","1","13","15","28","46.428571428571430","53.5714285714285700","MULHER"
"250330810000002","8","29","19","48","60.416666666666664","39.5833333333333360","HOMEM"
"250330815000001","1","35","12","47","74.468085106382970","25.5319148936170200","HOMEM"
"250330815000002","8","194","48","242","80.165289256198350","19.8347107438016540","HOMEM"
"250330815000003","8","86","38","124","69.354838709677420","30.6451612903225800","HOMEM"
"250330820000001","1","26","23","49","53.061224489795920","46.9387755102040800","HOMEM"
"250330820000002","8","64","64","128","50.000000000000000","50.0000000000000000","IGUAL"
"250330820000003","5","74","17","91","81.318681318681310","18.6813186813186820","HOMEM"
"250340705000001","1","144","54","198","72.727272727272730","27.2727272727272730","HOMEM"
"250340705000002","8","85","36","121","70.247933884297520","29.7520661157024800","HOMEM"
"250340705000003","8","107","39","146","73.287671232876720","26.7123287671232900","HOMEM"
"250340705000004","8","191","38","229","83.406113537117900","16.5938864628820970","HOMEM"
"250340705000005","8","23","13","36","63.888888888888886","36.1111111111111140","HOMEM"
"250340705000006","1","188","113","301","62.458471760797345","37.5415282392026550","HOMEM"
"250350605000001","1","116","72","188","61.702127659574465","38.2978723404255350","HOMEM"
"250350605000002","1","132","82","214","61.682242990654200","38.3177570093458000","HOMEM"
"250350605000003","1","75","75","150","50.000000000000000","50.0000000000000000","IGUAL"
"250350605000004","1","92","63","155","59.354838709677416","40.6451612903225840","HOMEM"
"250350605000005","1","121","171","292","41.438356164383560","58.5616438356164400","MULHER"
"250350605000006","1","182","96","278","65.467625899280580","34.5323741007194200","HOMEM"
"250350605000007","1","151","110","261","57.854406130268200","42.1455938697318000","HOMEM"
"250350605000008","8","141","60","201","70.149253731343280","29.8507462686567170","HOMEM"
"250350605000009","8","101","49","150","67.333333333333330","32.6666666666666640","HOMEM"
"250350605000010","8","118","29","147","80.272108843537410","19.7278911564625870","HOMEM"
"250350605000011","8","87","33","120","72.500000000000000","27.5000000000000000","HOMEM"
"250350605000012","8","47","16","63","74.603174603174610","25.3968253968253950","HOMEM"
"250350605000013","8","97","31","128","75.781250000000000","24.2187500000000000","HOMEM"
"250350605000014","8","59","20","79","74.683544303797460","25.3164556962025300","HOMEM"
"250350605000015","8","145","25","170","85.294117647058830","14.7058823529411760","HOMEM"
"250350605000016","8","32","51","83","38.554216867469880","61.4457831325301200","MULHER"
"250350605000017","8","18","3","21","85.714285714285710","14.2857142857142860","HOMEM"
"250350605000018","8","219","67","286","76.573426573426570","23.4265734265734270","HOMEM"
"250350605000019","5","269","156","425","63.294117647058826","36.7058823529411740","HOMEM"
"250350605000020","8","17","5","22","77.272727272727270","22.7272727272727270","HOMEM"
"250350605000021","5","69","47","116","59.482758620689660","40.5172413793103400","HOMEM"
"250350605000022","1","43","157","200","21.500000000000000","78.5000000000000000","MULHER"
"250350605000023","1","109","114","223","48.878923766816140","51.1210762331838600","MULHER"
"250350605000024","1","52","166","218","23.853211009174313","76.1467889908256800","MULHER"
"250350605000025","1","94","94","188","50.000000000000000","50.0000000000000000","IGUAL"
"250350605000026","1","142","82","224","63.392857142857146","36.6071428571428540","HOMEM"
"250355505000001","1","106","114","220","48.181818181818180","51.8181818181818200","MULHER"
"250355505000002","1","138","120","258","53.488372093023260","46.5116279069767400","HOMEM"
"250355505000003","8","99","145","244","40.573770491803280","59.4262295081967200","MULHER"
"250355505000004","8","38","28","66","57.575757575757580","42.4242424242424200","HOMEM"
"250355505000005","8","24","18","42","57.142857142857146","42.8571428571428540","HOMEM"
"250355505000006","8","4","13","17","23.529411764705884","76.4705882352941200","MULHER"
"250355505000007","8","42","80","122","34.426229508196720","65.5737704918032700","MULHER"
"250355505000008","8","107","90","197","54.314720812182740","45.6852791878172600","HOMEM"
"250355505000009","5","120","266","386","31.088082901554404","68.9119170984456000","MULHER"
"250355505000010","8","53","38","91","58.241758241758240","41.7582417582417600","HOMEM"
"250355505000011","8","89","76","165","53.939393939393940","46.0606060606060600","HOMEM"
"250360505000001","1","131","142","273","47.985347985347985","52.0146520146520150","MULHER"
"250360505000002","1","167","59","226","73.893805309734520","26.1061946902654860","HOMEM"
"250360505000003","1","115","218","333","34.534534534534540","65.4654654654654700","MULHER"
"250360505000004","1","97","159","256","37.890625000000000","62.1093750000000000","MULHER"
"250360505000005","1","134","120","254","52.755905511811020","47.2440944881889800","HOMEM"
"250360505000006","8","79","11","90","87.777777777777770","12.2222222222222210","HOMEM"
"250360505000007","8","72","24","96","75.000000000000000","25.0000000000000000","HOMEM"
"250360505000008","8","88","49","137","64.233576642335760","35.7664233576642300","HOMEM"
"250360505000009","8","91","32","123","73.983739837398370","26.0162601626016250","HOMEM"
"250360505000010","8","91","23","114","79.824561403508770","20.1754385964912300","HOMEM"
"250360505000011","1","147","51","198","74.242424242424250","25.7575757575757580","HOMEM"
"250370405000001","1","150","125","275","54.545454545454550","45.4545454545454500","HOMEM"
"250370405000002","1","129","117","246","52.439024390243900","47.5609756097561000","HOMEM"
"250370405000003","1","118","73","191","61.780104712041880","38.2198952879581200","HOMEM"
"250370405000004","1","114","122","236","48.305084745762710","51.6949152542372900","MULHER"
"250370405000005","1","142","153","295","48.135593220338980","51.8644067796610200","MULHER"
"250370405000006","1","100","124","224","44.642857142857146","55.3571428571428540","MULHER"
"250370405000007","1","110","181","291","37.800687285223370","62.1993127147766300","MULHER"
"250370405000008","1","158","122","280","56.428571428571430","43.5714285714285700","HOMEM"
"250370405000009","1","174","109","283","61.484098939929330","38.5159010600706700","HOMEM"
"250370405000010","1","122","82","204","59.803921568627450","40.1960784313725500","HOMEM"
"250370405000011","1","132","69","201","65.671641791044780","34.3283582089552200","HOMEM"
"250370405000012","1","202","83","285","70.877192982456140","29.1228070175438600","HOMEM"
"250370405000013","1","159","70","229","69.432314410480340","30.5676855895196500","HOMEM"
"250370405000014","1","191","142","333","57.357357357357360","42.6426426426426400","HOMEM"
"250370405000015","1","161","117","278","57.913669064748200","42.0863309352518000","HOMEM"
"250370405000016","1","306","107","413","74.092009685230020","25.9079903147699750","HOMEM"
"250370405000017","1","145","93","238","60.924369747899156","39.0756302521008440","HOMEM"
"250370405000018","1","122","112","234","52.136752136752136","47.8632478632478640","HOMEM"
"250370405000019","1","121","79","200","60.500000000000000","39.5000000000000000","HOMEM"
"250370405000020","1","86","72","158","54.430379746835440","45.5696202531645600","HOMEM"
"250370405000021","1","204","171","375","54.400000000000000","45.6000000000000000","HOMEM"
"250370405000022","1","182","130","312","58.333333333333336","41.6666666666666640","HOMEM"
"250370405000023","1","144","90","234","61.538461538461540","38.4615384615384600","HOMEM"
"250370405000024","1","75","173","248","30.241935483870968","69.7580645161290400","MULHER"
"250370405000025","1","124","109","233","53.218884120171670","46.7811158798283300","HOMEM"
"250370405000026","1","133","123","256","51.953125000000000","48.0468750000000000","HOMEM"
"250370405000027","1","162","108","270","60.000000000000000","40.0000000000000000","HOMEM"
"250370405000028","1","157","100","257","61.089494163424130","38.9105058365758700","HOMEM"
"250370405000029","1","220","105","325","67.692307692307700","32.3076923076923100","HOMEM"
"250370405000030","1","249","154","403","61.786600496277910","38.2133995037220900","HOMEM"
"250370405000031","1","153","80","233","65.665236051502150","34.3347639484978500","HOMEM"
"250370405000032","1","148","97","245","60.408163265306120","39.5918367346938800","HOMEM"
"250370405000033","1","116","236","352","32.954545454545450","67.0454545454545500","MULHER"
"250370405000034","1","203","109","312","65.064102564102570","34.9358974358974400","HOMEM"
"250370405000035","1","259","158","417","62.110311750599520","37.8896882494004800","HOMEM"
"250370405000036","1","224","144","368","60.869565217391305","39.1304347826086950","HOMEM"
"250370405000037","1","159","92","251","63.346613545816730","36.6533864541832700","HOMEM"
"250370405000038","1","196","170","366","53.551912568306010","46.4480874316939900","HOMEM"
"250370405000039","1","241","120","361","66.759002770083100","33.2409972299169000","HOMEM"
"250370405000040","8","137","36","173","79.190751445086700","20.8092485549132960","HOMEM"
"250370405000041","8","43","12","55","78.181818181818190","21.8181818181818170","HOMEM"
"250370405000042","8","205","67","272","75.367647058823540","24.6323529411764700","HOMEM"
"250370405000043","8","130","22","152","85.526315789473680","14.4736842105263150","HOMEM"
"250370405000044","8","87","36","123","70.731707317073170","29.2682926829268300","HOMEM"
"250370405000045","8","170","42","212","80.188679245283010","19.8113207547169800","HOMEM"
"250370405000046","8","199","57","256","77.734375000000000","22.2656250000000000","HOMEM"
"250370405000047","8","182","39","221","82.352941176470600","17.6470588235294130","HOMEM"
"250370405000048","5","77","29","106","72.641509433962270","27.3584905660377370","HOMEM"
"250370405000049","8","66","54","120","55.000000000000000","45.0000000000000000","HOMEM"
"250370405000050","8","26","9","35","74.285714285714290","25.7142857142857150","HOMEM"
"250370405000051","8","202","69","271","74.538745387453870","25.4612546125461240","HOMEM"
"250370405000052","8","176","40","216","81.481481481481480","18.5185185185185200","HOMEM"
"250370405000053","1","202","83","285","70.877192982456140","29.1228070175438600","HOMEM"
"250370405000054","1","187","85","272","68.750000000000000","31.2500000000000000","HOMEM"
"250370405000055","1","126","175","301","41.860465116279070","58.1395348837209300","MULHER"
"250370405000056","1","170","78","248","68.548387096774190","31.4516129032258080","HOMEM"
"250370405000057","1","161","38","199","80.904522613065320","19.0954773869346700","HOMEM"
"250370405000058","1","174","88","262","66.412213740458010","33.5877862595419860","HOMEM"
"250370405000059","1","77","175","252","30.555555555555557","69.4444444444444400","MULHER"
"250370405000060","1","264","131","395","66.835443037974680","33.1645569620253160","HOMEM"
"250370405000061","1","146","87","233","62.660944206008590","37.3390557939914100","HOMEM"
"250370405000062","1","98","55","153","64.052287581699350","35.9477124183006540","HOMEM"
"250370405000063","1","137","94","231","59.307359307359306","40.6926406926406940","HOMEM"
"250370405000064","1","138","90","228","60.526315789473685","39.4736842105263150","HOMEM"
"250370410000001","1","152","57","209","72.727272727272730","27.2727272727272730","HOMEM"
"250370410000002","8","70","5","75","93.333333333333330","6.6666666666666670","HOMEM"
"250370410000003","8","128","48","176","72.727272727272730","27.2727272727272730","HOMEM"
"250370410000004","8","115","65","180","63.888888888888886","36.1111111111111140","HOMEM"
"250370410000005","5","32","40","72","44.444444444444440","55.5555555555555600","MULHER"
"250370410000006","8","69","17","86","80.232558139534890","19.7674418604651160","HOMEM"
"250370410000007","8","138","72","210","65.714285714285710","34.2857142857142850","HOMEM"
"250370410000008","8","72","16","88","81.818181818181810","18.1818181818181830","HOMEM"
"250375305000001","1","184","93","277","66.425992779783400","33.5740072202166100","HOMEM"
"250375305000002","8","136","22","158","86.075949367088610","13.9240506329113920","HOMEM"
"250375305000003","8","139","108","247","56.275303643724700","43.7246963562753000","HOMEM"
"250375305000004","8","41","5","46","89.130434782608700","10.8695652173913050","HOMEM"
"250375305000005","8","60","2","62","96.774193548387100","3.2258064516129030","HOMEM"
"250375305000006","8","23","11","34","67.647058823529400","32.3529411764705900","HOMEM"
"250380305000001","1","195","144","339","57.522123893805310","42.4778761061946900","HOMEM"
"250380305000002","1","209","99","308","67.857142857142860","32.1428571428571460","HOMEM"
"250380305000003","1","223","127","350","63.714285714285715","36.2857142857142850","HOMEM"
"250380305000004","8","163","60","223","73.094170403587440","26.9058295964125560","HOMEM"
"250380305000005","8","72","18","90","80.000000000000000","20.0000000000000000","HOMEM"
"250380305000006","5","98","37","135","72.592592592592600","27.4074074074074100","HOMEM"
"250380305000007","5","165","93","258","63.953488372093030","36.0465116279069700","HOMEM"
"250390205000001","1","72","181","253","28.458498023715414","71.5415019762845800","MULHER"
"250390205000002","1","137","77","214","64.018691588785050","35.9813084112149540","HOMEM"
"250390205000003","1","132","126","258","51.162790697674420","48.8372093023255800","HOMEM"
"250390205000004","8","170","35","205","82.926829268292680","17.0731707317073180","HOMEM"
"250390205000005","8","32","54","86","37.209302325581400","62.7906976744186000","MULHER"
"250390205000006","8","113","43","156","72.435897435897430","27.5641025641025660","HOMEM"
"250390205000007","8","140","67","207","67.632850241545900","32.3671497584541040","HOMEM"
"250390205000008","7","44","21","65","67.692307692307700","32.3076923076923100","HOMEM"
"250390205000009","1","98","73","171","57.309941520467840","42.6900584795321600","HOMEM"
"250390210000001","1","34","43","77","44.155844155844160","55.8441558441558400","MULHER"
"250390210000002","8","117","48","165","70.909090909090900","29.0909090909090900","HOMEM"
"250400905000001","1","127","152","279","45.519713261648750","54.4802867383512500","MULHER"
"250400905000002","1","111","110","221","50.226244343891400","49.7737556561086000","HOMEM"
"250400905000003","1","98","73","171","57.309941520467840","42.6900584795321600","HOMEM"
"250400905000004","1","95","116","211","45.023696682464454","54.9763033175355460","MULHER"
"250400905000005","1","73","61","134","54.477611940298510","45.5223880597014900","HOMEM"
"250400905000006","1","154","117","271","56.826568265682660","43.1734317343173400","HOMEM"
"250400905000007","1","175","175","350","50.000000000000000","50.0000000000000000","IGUAL"
"250400905000008","1","109","75","184","59.239130434782610","40.7608695652173900","HOMEM"
"250400905000009","1","82","52","134","61.194029850746270","38.8059701492537300","HOMEM"
"250400905000010","1","135","135","270","50.000000000000000","50.0000000000000000","IGUAL"
"250400905000011","1","102","93","195","52.307692307692310","47.6923076923076900","HOMEM"
"250400905000012","1","98","106","204","48.039215686274510","51.9607843137254900","MULHER"
"250400905000013","1","109","92","201","54.228855721393030","45.7711442786069700","HOMEM"
"250400905000014","1","118","133","251","47.011952191235060","52.9880478087649400","MULHER"
"250400905000015","1","33","54","87","37.931034482758620","62.0689655172413800","MULHER"
"250400905000016","1","110","104","214","51.401869158878505","48.5981308411214950","HOMEM"
"250400905000017","1","132","117","249","53.012048192771080","46.9879518072289200","HOMEM"
"250400905000018","1","139","150","289","48.096885813148790","51.9031141868512100","MULHER"
"250400905000019","1","128","126","254","50.393700787401580","49.6062992125984200","HOMEM"
"250400905000020","1","135","175","310","43.548387096774190","56.4516129032258100","MULHER"
"250400905000021","1","130","73","203","64.039408866995070","35.9605911330049250","HOMEM"
"250400905000022","1","74","67","141","52.482269503546100","47.5177304964539000","HOMEM"
"250400905000023","1","66","107","173","38.150289017341040","61.8497109826589600","MULHER"
"250400905000024","1","144","106","250","57.600000000000000","42.4000000000000000","HOMEM"
"250400905000026","1","107","173","280","38.214285714285715","61.7857142857142850","MULHER"
"250400905000027","1","166","89","255","65.098039215686270","34.9019607843137200","HOMEM"
"250400905000028","1","158","98","256","61.718750000000000","38.2812500000000000","HOMEM"
"250400905000029","1","181","98","279","64.874551971326170","35.1254480286738400","HOMEM"
"250400905000030","1","111","96","207","53.623188405797100","46.3768115942029000","HOMEM"
"250400905000031","1","106","152","258","41.085271317829460","58.9147286821705400","MULHER"
"250400905000032","1","170","160","330","51.515151515151516","48.4848484848484840","HOMEM"
"250400905000033","1","129","106","235","54.893617021276600","45.1063829787234000","HOMEM"
"250400905000034","1","127","142","269","47.211895910780670","52.7881040892193300","MULHER"
"250400905000035","1","176","96","272","64.705882352941170","35.2941176470588260","HOMEM"
"250400905000036","1","187","105","292","64.041095890410960","35.9589041095890400","HOMEM"
"250400905000037","1","120","143","263","45.627376425855516","54.3726235741444840","MULHER"
"250400905000038","1","173","61","234","73.931623931623930","26.0683760683760680","HOMEM"
"250400905000039","1","143","118","261","54.789272030651340","45.2107279693486600","HOMEM"
"250400905000040","1","160","138","298","53.691275167785236","46.3087248322147640","HOMEM"
"250400905000041","1","142","109","251","56.573705179282870","43.4262948207171300","HOMEM"
"250400905000042","1","108","108","216","50.000000000000000","50.0000000000000000","IGUAL"
"250400905000043","1","131","157","288","45.486111111111114","54.5138888888888860","MULHER"
"250400905000044","1","116","85","201","57.711442786069654","42.2885572139303460","HOMEM"
"250400905000045","1","148","133","281","52.669039145907476","47.3309608540925240","HOMEM"
"250400905000046","1","147","95","242","60.743801652892564","39.2561983471074360","HOMEM"
"250400905000047","1","125","115","240","52.083333333333336","47.9166666666666640","HOMEM"
"250400905000048","1","178","107","285","62.456140350877190","37.5438596491228100","HOMEM"
"250400905000049","1","169","127","296","57.094594594594600","42.9054054054054000","HOMEM"
"250400905000050","1","140","109","249","56.224899598393580","43.7751004016064200","HOMEM"
"250400905000051","1","134","115","249","53.815261044176710","46.1847389558232900","HOMEM"
"250400905000052","1","145","122","267","54.307116104868910","45.6928838951310900","HOMEM"
"250400905000053","1","161","163","324","49.691358024691360","50.3086419753086400","MULHER"
"250400905000054","1","97","53","150","64.666666666666670","35.3333333333333360","HOMEM"
"250400905000055","1","40","210","250","16.000000000000000","84.0000000000000000","MULHER"
"250400905000056","1","155","135","290","53.448275862068970","46.5517241379310300","HOMEM"
"250400905000057","1","133","168","301","44.186046511627910","55.8139534883720900","MULHER"
"250400905000058","1","136","171","307","44.299674267100976","55.7003257328990240","MULHER"
"250400905000059","1","176","151","327","53.822629969418960","46.1773700305810400","HOMEM"
"250400905000060","1","185","157","342","54.093567251461990","45.9064327485380100","HOMEM"
"250400905000061","1","133","102","235","56.595744680851060","43.4042553191489400","HOMEM"
"250400905000062","1","92","62","154","59.740259740259740","40.2597402597402600","HOMEM"
"250400905000063","1","160","205","365","43.835616438356160","56.1643835616438400","MULHER"
"250400905000064","1","143","59","202","70.792079207920790","29.2079207920792070","HOMEM"
"250400905000065","1","65","104","169","38.461538461538460","61.5384615384615400","MULHER"
"250400905000066","1","79","90","169","46.745562130177520","53.2544378698224800","MULHER"
"250400905000067","1","77","95","172","44.767441860465120","55.2325581395348800","MULHER"
"250400905000068","1","81","39","120","67.500000000000000","32.5000000000000000","HOMEM"
"250400905000069","1","103","86","189","54.497354497354500","45.5026455026455000","HOMEM"
"250400905000070","1","118","62","180","65.555555555555560","34.4444444444444400","HOMEM"
"250400905000071","1","174","83","257","67.704280155642020","32.2957198443579760","HOMEM"
"250400905000072","1","87","61","148","58.783783783783780","41.2162162162162200","HOMEM"
"250400905000073","1","189","162","351","53.846153846153850","46.1538461538461500","HOMEM"
"250400905000074","1","0","0","0",NULL,NULL,NULL
"250400905000075","1","131","187","318","41.194968553459120","58.8050314465408800","MULHER"
"250400905000076","1","128","106","234","54.700854700854700","45.2991452991453000","HOMEM"
"250400905000077","1","178","169","347","51.296829971181560","48.7031700288184400","HOMEM"
"250400905000078","1","147","136","283","51.943462897526500","48.0565371024735000","HOMEM"
"250400905000079","1","158","147","305","51.803278688524590","48.1967213114754100","HOMEM"
"250400905000080","1","111","67","178","62.359550561797754","37.6404494382022460","HOMEM"
"250400905000081","1","27","17","44","61.363636363636370","38.6363636363636300","HOMEM"
"250400905000082","1","146","152","298","48.993288590604024","51.0067114093959760","MULHER"
"250400905000083","1","170","159","329","51.671732522796354","48.3282674772036460","HOMEM"
"250400905000084","1","133","102","235","56.595744680851060","43.4042553191489400","HOMEM"
"250400905000085","1","112","154","266","42.105263157894740","57.8947368421052600","MULHER"
"250400905000086","1","136","131","267","50.936329588014980","49.0636704119850200","HOMEM"
"250400905000087","1","146","121","267","54.681647940074900","45.3183520599251000","HOMEM"
"250400905000088","1","110","182","292","37.671232876712330","62.3287671232876700","MULHER"
"250400905000089","1","202","111","313","64.536741214057510","35.4632587859424900","HOMEM"
"250400905000090","1","163","108","271","60.147601476014760","39.8523985239852400","HOMEM"
"250400905000091","1","196","98","294","66.666666666666670","33.3333333333333360","HOMEM"
"250400905000092","1","221","128","349","63.323782234957020","36.6762177650429800","HOMEM"
"250400905000093","1","159","99","258","61.627906976744185","38.3720930232558150","HOMEM"
"250400905000094","1","189","146","335","56.417910447761194","43.5820895522388060","HOMEM"
"250400905000095","1","163","148","311","52.411575562700970","47.5884244372990300","HOMEM"
"250400905000096","1","157","85","242","64.876033057851250","35.1239669421487600","HOMEM"
"250400905000097","1","129","144","273","47.252747252747255","52.7472527472527450","MULHER"
"250400905000098","1","73","176","249","29.317269076305220","70.6827309236947800","MULHER"
"250400905000099","1","77","71","148","52.027027027027025","47.9729729729729750","HOMEM"
"250400905000100","1","60","101","161","37.267080745341616","62.7329192546583840","MULHER"
"250400905000101","1","162","142","304","53.289473684210530","46.7105263157894700","HOMEM"
"250400905000102","1","90","147","237","37.974683544303800","62.0253164556962000","MULHER"
"250400905000103","1","196","141","337","58.160237388724035","41.8397626112759650","HOMEM"
"250400905000104","1","110","97","207","53.140096618357490","46.8599033816425100","HOMEM"
"250400905000105","1","197","125","322","61.180124223602480","38.8198757763975200","HOMEM"
"250400905000106","1","158","106","264","59.848484848484850","40.1515151515151500","HOMEM"
"250400905000107","1","177","122","299","59.197324414715716","40.8026755852842840","HOMEM"
"250400905000108","1","191","113","304","62.828947368421055","37.1710526315789450","HOMEM"
"250400905000109","1","172","135","307","56.026058631921820","43.9739413680781800","HOMEM"
"250400905000110","1","121","85","206","58.737864077669904","41.2621359223300960","HOMEM"
"250400905000111","1","245","172","417","58.752997601918466","41.2470023980815340","HOMEM"
"250400905000112","1","121","49","170","71.176470588235290","28.8235294117647070","HOMEM"
"250400905000113","1","191","122","313","61.022364217252395","38.9776357827476050","HOMEM"
"250400905000114","1","57","35","92","61.956521739130440","38.0434782608695600","HOMEM"
"250400905000115","1","103","117","220","46.818181818181820","53.1818181818181800","MULHER"
"250400905000116","1","147","113","260","56.538461538461540","43.4615384615384600","HOMEM"
"250400905000117","1","97","164","261","37.164750957854410","62.8352490421455900","MULHER"
"250400905000118","1","177","127","304","58.223684210526315","41.7763157894736850","HOMEM"
"250400905000119","1","80","146","226","35.398230088495570","64.6017699115044200","MULHER"
"250400905000120","1","160","125","285","56.140350877192980","43.8596491228070200","HOMEM"
"250400905000121","1","117","118","235","49.787234042553195","50.2127659574468050","MULHER"
"250400905000122","1","156","108","264","59.090909090909090","40.9090909090909100","HOMEM"
"250400905000123","1","182","108","290","62.758620689655174","37.2413793103448260","HOMEM"
"250400905000124","1","180","132","312","57.692307692307690","42.3076923076923100","HOMEM"
"250400905000125","1","144","109","253","56.916996047430830","43.0830039525691700","HOMEM"
"250400905000126","1","99","132","231","42.857142857142854","57.1428571428571460","MULHER"
"250400905000127","1","146","131","277","52.707581227436826","47.2924187725631740","HOMEM"
"250400905000128","1","181","141","322","56.211180124223600","43.7888198757764000","HOMEM"
"250400905000129","1","138","126","264","52.272727272727270","47.7272727272727300","HOMEM"
"250400905000130","1","144","117","261","55.172413793103445","44.8275862068965550","HOMEM"
"250400905000131","1","166","80","246","67.479674796747970","32.5203252032520350","HOMEM"
"250400905000132","1","181","75","256","70.703125000000000","29.2968750000000000","HOMEM"
"250400905000133","1","197","72","269","73.234200743494430","26.7657992565055770","HOMEM"
"250400905000134","1","201","110","311","64.630225080385860","35.3697749196141440","HOMEM"
"250400905000135","1","133","124","257","51.750972762645915","48.2490272373540850","HOMEM"
"250400905000136","1","151","137","288","52.430555555555560","47.5694444444444400","HOMEM"
"250400905000137","1","73","182","255","28.627450980392158","71.3725490196078500","MULHER"
"250400905000138","1","87","214","301","28.903654485049834","71.0963455149501700","MULHER"
"250400905000139","1","218","104","322","67.701863354037270","32.2981366459627350","HOMEM"
"250400905000140","1","259","243","502","51.593625498007970","48.4063745019920300","HOMEM"
"250400905000141","1","237","79","316","75.000000000000000","25.0000000000000000","HOMEM"
"250400905000142","1","215","115","330","65.151515151515160","34.8484848484848500","HOMEM"
"250400905000143","1","93","53","146","63.698630136986300","36.3013698630137000","HOMEM"
"250400905000144","1","205","120","325","63.076923076923080","36.9230769230769200","HOMEM"
"250400905000145","1","200","101","301","66.445182724252490","33.5548172757475100","HOMEM"
"250400905000146","1","184","125","309","59.546925566343040","40.4530744336569600","HOMEM"
"250400905000147","1","152","78","230","66.086956521739130","33.9130434782608700","HOMEM"
"250400905000148","1","70","166","236","29.661016949152543","70.3389830508474600","MULHER"
"250400905000149","1","156","123","279","55.913978494623656","44.0860215053763440","HOMEM"
"250400905000150","1","122","123","245","49.795918367346935","50.2040816326530650","MULHER"
"250400905000151","1","146","114","260","56.153846153846150","43.8461538461538500","HOMEM"
"250400905000152","1","172","113","285","60.350877192982460","39.6491228070175400","HOMEM"
"250400905000153","1","76","207","283","26.855123674911660","73.1448763250883300","MULHER"
"250400905000154","1","123","112","235","52.340425531914896","47.6595744680851040","HOMEM"
"250400905000155","1","176","109","285","61.754385964912280","38.2456140350877200","HOMEM"
"250400905000156","1","144","103","247","58.299595141700410","41.7004048582995900","HOMEM"
"250400905000158","1","7","2","9","77.777777777777770","22.2222222222222200","HOMEM"
"250400905000159","1","87","25","112","77.678571428571430","22.3214285714285730","HOMEM"
"250400905000160","1","201","115","316","63.607594936708864","36.3924050632911360","HOMEM"
"250400905000161","1","162","105","267","60.674157303370784","39.3258426966292160","HOMEM"
"250400905000162","1","182","166","348","52.298850574712645","47.7011494252873550","HOMEM"
"250400905000163","1","195","141","336","58.035714285714285","41.9642857142857150","HOMEM"
"250400905000164","1","131","93","224","58.482142857142854","41.5178571428571460","HOMEM"
"250400905000165","1","153","190","343","44.606413994169095","55.3935860058309050","MULHER"
"250400905000166","1","102","105","207","49.275362318840580","50.7246376811594200","MULHER"
"250400905000167","1","69","74","143","48.251748251748250","51.7482517482517500","MULHER"
"250400905000168","1","110","67","177","62.146892655367230","37.8531073446327700","HOMEM"
"250400905000169","1","196","132","328","59.756097560975610","40.2439024390243900","HOMEM"
"250400905000170","1","116","167","283","40.989399293286220","59.0106007067137800","MULHER"
"250400905000171","1","214","98","312","68.589743589743590","31.4102564102564100","HOMEM"
"250400905000172","1","266","110","376","70.744680851063830","29.2553191489361700","HOMEM"
"250400905000173","1","177","169","346","51.156069364161850","48.8439306358381500","HOMEM"
"250400905000174","1","91","62","153","59.477124183006540","40.5228758169934600","HOMEM"
"250400905000175","1","144","79","223","64.573991031390140","35.4260089686098640","HOMEM"
"250400905000176","1","165","157","322","51.242236024844720","48.7577639751552800","HOMEM"
"250400905000177","1","226","108","334","67.664670658682640","32.3353293413173700","HOMEM"
"250400905000178","1","212","135","347","61.095100864553320","38.9048991354466800","HOMEM"
"250400905000179","1","153","125","278","55.035971223021580","44.9640287769784200","HOMEM"
"250400905000180","1","75","228","303","24.752475247524753","75.2475247524752400","MULHER"
"250400905000181","1","82","245","327","25.076452599388380","74.9235474006116200","MULHER"
"250400905000182","1","312","242","554","56.317689530685920","43.6823104693140800","HOMEM"
"250400905000183","1","195","51","246","79.268292682926830","20.7317073170731700","HOMEM"
"250400905000184","1","116","90","206","56.310679611650485","43.6893203883495150","HOMEM"
"250400905000185","1","275","106","381","72.178477690288720","27.8215223097112880","HOMEM"
"250400905000186","1","207","83","290","71.379310344827590","28.6206896551724130","HOMEM"
"250400905000187","1","79","103","182","43.406593406593410","56.5934065934065900","MULHER"
"250400905000188","1","127","67","194","65.463917525773200","34.5360824742268000","HOMEM"
"250400905000189","1","125","98","223","56.053811659192824","43.9461883408071760","HOMEM"
"250400905000190","1","84","226","310","27.096774193548388","72.9032258064516200","MULHER"
"250400905000191","1","116","110","226","51.327433628318590","48.6725663716814100","HOMEM"
"250400905000192","1","115","169","284","40.492957746478870","59.5070422535211300","MULHER"
"250400905000193","1","187","122","309","60.517799352750810","39.4822006472491900","HOMEM"
"250400905000194","1","193","108","301","64.119601328903660","35.8803986710963440","HOMEM"
"250400905000195","1","27","31","58","46.551724137931030","53.4482758620689700","MULHER"
"250400905000196","1","186","110","296","62.837837837837840","37.1621621621621600","HOMEM"
"250400905000197","1","135","144","279","48.387096774193550","51.6129032258064500","MULHER"
"250400905000198","1","259","181","440","58.863636363636370","41.1363636363636300","HOMEM"
"250400905000199","1","96","63","159","60.377358490566040","39.6226415094339600","HOMEM"
"250400905000200","1","120","76","196","61.224489795918366","38.7755102040816340","HOMEM"
"250400905000201","1","111","30","141","78.723404255319150","21.2765957446808500","HOMEM"
"250400905000202","1","106","34","140","75.714285714285710","24.2857142857142850","HOMEM"
"250400905000203","1","203","108","311","65.273311897106110","34.7266881028938900","HOMEM"
"250400905000204","1","225","127","352","63.920454545454550","36.0795454545454500","HOMEM"
"250400905000205","1","164","77","241","68.049792531120330","31.9502074688796700","HOMEM"
"250400905000206","1","204","86","290","70.344827586206890","29.6551724137931030","HOMEM"
"250400905000207","1","256","127","383","66.840731070496090","33.1592689295039200","HOMEM"
"250400905000208","1","108","45","153","70.588235294117650","29.4117647058823500","HOMEM"
"250400905000209","1","108","78","186","58.064516129032256","41.9354838709677440","HOMEM"
"250400905000210","1","148","41","189","78.306878306878300","21.6931216931216930","HOMEM"
"250400905000211","1","37","54","91","40.659340659340660","59.3406593406593400","MULHER"
"250400905000212","1","72","262","334","21.556886227544910","78.4431137724550900","MULHER"
"250400905000213","1","136","65","201","67.661691542288550","32.3383084577114400","HOMEM"
"250400905000214","1","135","209","344","39.244186046511630","60.7558139534883700","MULHER"
"250400905000215","1","194","51","245","79.183673469387760","20.8163265306122440","HOMEM"
"250400905000216","1","138","105","243","56.790123456790130","43.2098765432098700","HOMEM"
"250400905000217","1","187","102","289","64.705882352941170","35.2941176470588260","HOMEM"
"250400905000218","1","151","95","246","61.382113821138210","38.6178861788617900","HOMEM"
"250400905000219","1","54","54","108","50.000000000000000","50.0000000000000000","IGUAL"
"250400905000220","1","130","34","164","79.268292682926830","20.7317073170731700","HOMEM"
"250400905000221","1","224","117","341","65.689149560117300","34.3108504398827000","HOMEM"
"250400905000222","1","94","49","143","65.734265734265730","34.2657342657342700","HOMEM"
"250400905000223","1","135","53","188","71.808510638297880","28.1914893617021300","HOMEM"
"250400905000224","1","135","60","195","69.230769230769230","30.7692307692307700","HOMEM"
"250400905000225","1","100","73","173","57.803468208092480","42.1965317919075200","HOMEM"
"250400905000226","1","201","115","316","63.607594936708864","36.3924050632911360","HOMEM"
"250400905000227","1","255","125","380","67.105263157894740","32.8947368421052600","HOMEM"
"250400905000228","1","180","116","296","60.810810810810814","39.1891891891891860","HOMEM"
"250400905000229","1","88","66","154","57.142857142857146","42.8571428571428540","HOMEM"
"250400905000230","1","86","24","110","78.181818181818190","21.8181818181818170","HOMEM"
"250400905000231","1","167","108","275","60.727272727272730","39.2727272727272700","HOMEM"
"250400905000232","1","86","149","235","36.595744680851060","63.4042553191489400","MULHER"
"250400905000233","1","46","16","62","74.193548387096770","25.8064516129032240","HOMEM"
"250400905000234","1","217","113","330","65.757575757575750","34.2424242424242400","HOMEM"
"250400905000235","1","148","111","259","57.142857142857146","42.8571428571428540","HOMEM"
"250400905000236","1","57","31","88","64.772727272727270","35.2272727272727300","HOMEM"
"250400905000237","1","119","125","244","48.770491803278690","51.2295081967213100","MULHER"
"250400905000238","1","78","82","160","48.750000000000000","51.2500000000000000","MULHER"
"250400905000239","1","129","126","255","50.588235294117645","49.4117647058823550","HOMEM"
"250400905000240","1","113","90","203","55.665024630541870","44.3349753694581300","HOMEM"
"250400905000241","1","74","177","251","29.482071713147410","70.5179282868526000","MULHER"
"250400905000242","1","73","77","150","48.666666666666664","51.3333333333333360","MULHER"
"250400905000243","1","163","112","275","59.272727272727270","40.7272727272727300","HOMEM"
"250400905000244","1","49","97","146","33.561643835616440","66.4383561643835600","MULHER"
"250400905000245","1","58","41","99","58.585858585858590","41.4141414141414100","HOMEM"
"250400905000246","1","153","97","250","61.200000000000000","38.8000000000000000","HOMEM"
"250400905000247","1","162","109","271","59.778597785977860","40.2214022140221400","HOMEM"
"250400905000248","1","195","81","276","70.652173913043480","29.3478260869565230","HOMEM"
"250400905000249","1","223","122","345","64.637681159420300","35.3623188405797100","HOMEM"
"250400905000250","1","434","128","562","77.224199288256230","22.7758007117437740","HOMEM"
"250400905000251","1","117","53","170","68.823529411764710","31.1764705882352930","HOMEM"
"250400905000252","1","151","95","246","61.382113821138210","38.6178861788617900","HOMEM"
"250400905000253","1","225","64","289","77.854671280276820","22.1453287197231800","HOMEM"
"250400905000254","1","126","114","240","52.500000000000000","47.5000000000000000","HOMEM"
"250400905000255","1","147","161","308","47.727272727272730","52.2727272727272700","MULHER"
"250400905000256","1","121","100","221","54.751131221719454","45.2488687782805460","HOMEM"
"250400905000257","1","141","108","249","56.626506024096386","43.3734939759036140","HOMEM"
"250400905000258","1","138","205","343","40.233236151603500","59.7667638483965000","MULHER"
"250400905000259","1","164","74","238","68.907563025210080","31.0924369747899160","HOMEM"
"250400905000260","1","130","107","237","54.852320675105490","45.1476793248945100","HOMEM"
"250400905000261","1","164","85","249","65.863453815261040","34.1365461847389540","HOMEM"
"250400905000262","1","147","70","217","67.741935483870960","32.2580645161290300","HOMEM"
"250400905000263","1","98","173","271","36.162361623616235","63.8376383763837650","MULHER"
"250400905000264","1","140","85","225","62.222222222222220","37.7777777777777800","HOMEM"
"250400905000265","1","93","32","125","74.400000000000000","25.6000000000000000","HOMEM"
"250400905000266","1","117","133","250","46.800000000000000","53.2000000000000000","MULHER"
"250400905000267","1","120","55","175","68.571428571428570","31.4285714285714270","HOMEM"
"250400905000268","1","75","33","108","69.444444444444440","30.5555555555555570","HOMEM"
"250400905000269","1","92","68","160","57.500000000000000","42.5000000000000000","HOMEM"
"250400905000270","1","172","139","311","55.305466237942120","44.6945337620578800","HOMEM"
"250400905000271","1","229","98","327","70.030581039755350","29.9694189602446500","HOMEM"
"250400905000272","1","169","104","273","61.904761904761905","38.0952380952380950","HOMEM"
"250400905000273","1","249","137","386","64.507772020725380","35.4922279792746100","HOMEM"
"250400905000274","1","137","79","216","63.425925925925924","36.5740740740740760","HOMEM"
"250400905000275","1","245","168","413","59.322033898305090","40.6779661016949100","HOMEM"
"250400905000276","1","140","179","319","43.887147335423200","56.1128526645768000","MULHER"
"250400905000277","1","143","176","319","44.827586206896555","55.1724137931034450","MULHER"
"250400905000278","1","122","169","291","41.924398625429550","58.0756013745704500","MULHER"
"250400905000279","1","184","90","274","67.153284671532840","32.8467153284671550","HOMEM"
"250400905000280","1","186","145","331","56.193353474320240","43.8066465256797600","HOMEM"
"250400905000281","1","217","121","338","64.201183431952660","35.7988165680473360","HOMEM"
"250400905000282","1","137","51","188","72.872340425531920","27.1276595744680870","HOMEM"
"250400905000283","1","212","105","317","66.876971608832800","33.1230283911671900","HOMEM"
"250400905000284","1","154","124","278","55.395683453237410","44.6043165467625900","HOMEM"
"250400905000285","1","226","124","350","64.571428571428570","35.4285714285714300","HOMEM"
"250400905000286","1","264","110","374","70.588235294117650","29.4117647058823500","HOMEM"
"250400905000287","1","120","48","168","71.428571428571430","28.5714285714285730","HOMEM"
"250400905000288","1","135","94","229","58.951965065502186","41.0480349344978140","HOMEM"
"250400905000289","1","183","93","276","66.304347826086950","33.6956521739130500","HOMEM"
"250400905000290","1","119","55","174","68.390804597701150","31.6091954022988500","HOMEM"
"250400905000291","1","214","102","316","67.721518987341770","32.2784810126582260","HOMEM"
"250400905000292","1","233","94","327","71.253822629969420","28.7461773700305800","HOMEM"
"250400905000293","1","240","124","364","65.934065934065930","34.0659340659340660","HOMEM"
"250400905000294","1","128","104","232","55.172413793103445","44.8275862068965550","HOMEM"
"250400905000295","1","214","116","330","64.848484848484840","35.1515151515151500","HOMEM"
"250400905000296","1","199","87","286","69.580419580419590","30.4195804195804200","HOMEM"
"250400905000297","1","153","120","273","56.043956043956044","43.9560439560439560","HOMEM"
"250400905000298","1","128","177","305","41.967213114754095","58.0327868852459050","MULHER"
"250400905000299","1","87","62","149","58.389261744966440","41.6107382550335600","HOMEM"
"250400905000300","1","142","105","247","57.489878542510120","42.5101214574898800","HOMEM"
"250400905000301","1","245","112","357","68.627450980392150","31.3725490196078420","HOMEM"
"250400905000302","1","189","67","256","73.828125000000000","26.1718750000000000","HOMEM"
"250400905000303","1","100","210","310","32.258064516129030","67.7419354838709600","MULHER"
"250400905000304","1","166","131","297","55.892255892255890","44.1077441077441100","HOMEM"
"250400905000305","1","123","62","185","66.486486486486480","33.5135135135135160","HOMEM"
"250400905000306","1","203","77","280","72.500000000000000","27.5000000000000000","HOMEM"
"250400905000307","1","169","138","307","55.048859934853420","44.9511400651465800","HOMEM"
"250400905000308","1","152","154","306","49.673202614379086","50.3267973856209140","MULHER"
"250400905000309","1","156","105","261","59.770114942528735","40.2298850574712650","HOMEM"
"250400905000310","1","176","84","260","67.692307692307700","32.3076923076923100","HOMEM"
"250400905000311","1","117","98","215","54.418604651162790","45.5813953488372100","HOMEM"
"250400905000312","1","218","152","370","58.918918918918920","41.0810810810810800","HOMEM"
"250400905000313","1","242","123","365","66.301369863013700","33.6986301369863000","HOMEM"
"250400905000314","1","98","34","132","74.242424242424250","25.7575757575757580","HOMEM"
"250400905000315","1","107","131","238","44.957983193277310","55.0420168067226900","MULHER"
"250400905000316","1","116","140","256","45.312500000000000","54.6875000000000000","MULHER"
"250400905000317","1","138","43","181","76.243093922651940","23.7569060773480660","HOMEM"
"250400905000318","1","148","77","225","65.777777777777770","34.2222222222222200","HOMEM"
"250400905000319","1","92","224","316","29.113924050632910","70.8860759493670800","MULHER"
"250400905000320","1","0","0","0",NULL,NULL,NULL
"250400905000321","1","196","108","304","64.473684210526320","35.5263157894736850","HOMEM"
"250400905000322","1","74","112","186","39.784946236559136","60.2150537634408640","MULHER"
"250400905000323","1","240","102","342","70.175438596491230","29.8245614035087700","HOMEM"
"250400905000324","1","89","54","143","62.237762237762240","37.7622377622377600","HOMEM"
"250400905000325","1","65","21","86","75.581395348837200","24.4186046511627900","HOMEM"
"250400905000326","1","30","34","64","46.875000000000000","53.1250000000000000","MULHER"
"250400905000327","1","209","109","318","65.723270440251570","34.2767295597484250","HOMEM"
"250400905000328","1","72","235","307","23.452768729641694","76.5472312703583100","MULHER"
"250400905000329","1","123","51","174","70.689655172413800","29.3103448275862060","HOMEM"
"250400905000330","1","14","11","25","56.000000000000000","44.0000000000000000","HOMEM"
"250400905000331","4","147","69","216","68.055555555555560","31.9444444444444430","HOMEM"
"250400905000332","4","207","100","307","67.426710097719880","32.5732899022801300","HOMEM"
"250400905000333","4","100","61","161","62.111801242236030","37.8881987577639700","HOMEM"
"250400905000334","8","174","44","218","79.816513761467890","20.1834862385321100","HOMEM"
"250400905000335","8","51","16","67","76.119402985074630","23.8805970149253750","HOMEM"
"250400905000336","8","74","40","114","64.912280701754380","35.0877192982456200","HOMEM"
"250400905000337","8","33","42","75","44.000000000000000","56.0000000000000000","MULHER"
"250400905000338","8","185","43","228","81.140350877192990","18.8596491228070170","HOMEM"
"250400905000339","1","157","45","202","77.722772277227720","22.2772277227722770","HOMEM"
"250400905000340","1","205","84","289","70.934256055363320","29.0657439446366800","HOMEM"
"250400905000341","1","55","51","106","51.886792452830186","48.1132075471698140","HOMEM"
"250400905000342","1","137","94","231","59.307359307359306","40.6926406926406940","HOMEM"
"250400905000343","1","136","51","187","72.727272727272730","27.2727272727272730","HOMEM"
"250400905000344","1","169","55","224","75.446428571428570","24.5535714285714270","HOMEM"
"250400905000345","1","229","127","356","64.325842696629210","35.6741573033707840","HOMEM"
"250400905000346","1","123","114","237","51.898734177215190","48.1012658227848100","HOMEM"
"250400905000347","1","44","24","68","64.705882352941170","35.2941176470588260","HOMEM"
"250400905000348","1","102","68","170","60.000000000000000","40.0000000000000000","HOMEM"
"250400905000349","1","91","49","140","65.000000000000000","35.0000000000000000","HOMEM"
"250400905000350","1","71","42","113","62.831858407079640","37.1681415929203600","HOMEM"
"250400905000351","1","60","50","110","54.545454545454550","45.4545454545454500","HOMEM"
"250400905000353","1","36","28","64","56.250000000000000","43.7500000000000000","HOMEM"
"250400905000354","1","97","57","154","62.987012987012990","37.0129870129870100","HOMEM"
"250400905000355","1","144","75","219","65.753424657534250","34.2465753424657500","HOMEM"
"250400905000356","1","81","69","150","54.000000000000000","46.0000000000000000","HOMEM"
"250400905000357","1","155","84","239","64.853556485355650","35.1464435146443500","HOMEM"
"250400905000358","1","198","98","296","66.891891891891890","33.1081081081081050","HOMEM"
"250400905000359","1","144","46","190","75.789473684210520","24.2105263157894730","HOMEM"
"250400905000360","1","152","90","242","62.809917355371900","37.1900826446281000","HOMEM"
"250400905000361","1","189","30","219","86.301369863013700","13.6986301369863010","HOMEM"
"250400905000362","1","12","3","15","80.000000000000000","20.0000000000000000","HOMEM"
"250400905000363","1","199","62","261","76.245210727969350","23.7547892720306530","HOMEM"
"250400905000364","1","127","52","179","70.949720670391060","29.0502793296089370","HOMEM"
"250400905000365","1","76","201","277","27.436823104693140","72.5631768953068500","MULHER"
"250400905000366","1","151","65","216","69.907407407407400","30.0925925925925900","HOMEM"
"250400905000367","1","154","73","227","67.841409691629960","32.1585903083700440","HOMEM"
"250400905000368","1","25","25","50","50.000000000000000","50.0000000000000000","IGUAL"
"250400905000369","1","197","52","249","79.116465863453810","20.8835341365461850","HOMEM"
"250400905000370","1","172","70","242","71.074380165289260","28.9256198347107440","HOMEM"
"250400905000371","1","139","66","205","67.804878048780500","32.1951219512195100","HOMEM"
"250400905000372","1","76","45","121","62.809917355371900","37.1900826446281000","HOMEM"
"250400905000373","1","70","115","185","37.837837837837840","62.1621621621621600","MULHER"
"250400905000374","1","169","49","218","77.522935779816500","22.4770642201834860","HOMEM"
"250400905000375","1","110","87","197","55.837563451776650","44.1624365482233500","HOMEM"
"250400905000376","1","141","92","233","60.515021459227470","39.4849785407725300","HOMEM"
"250400905000377","1","170","95","265","64.150943396226410","35.8490566037735800","HOMEM"
"250400905000378","1","65","24","89","73.033707865168540","26.9662921348314600","HOMEM"
"250400905000379","1","142","73","215","66.046511627906980","33.9534883720930300","HOMEM"
"250400905000380","1","71","101","172","41.279069767441860","58.7209302325581400","MULHER"
"250400905000381","1","143","164","307","46.579804560260584","53.4201954397394160","MULHER"
"250400905000382","1","42","72","114","36.842105263157900","63.1578947368421000","MULHER"
"250400905000383","1","163","78","241","67.634854771784230","32.3651452282157660","HOMEM"
"250400905000384","1","181","40","221","81.900452488687780","18.0995475113122170","HOMEM"
"250400905000385","1","162","64","226","71.681415929203540","28.3185840707964600","HOMEM"
"250400905000386","1","55","47","102","53.921568627450980","46.0784313725490200","HOMEM"
"250400905000387","1","32","26","58","55.172413793103445","44.8275862068965550","HOMEM"
"250400905000388","1","92","43","135","68.148148148148150","31.8518518518518500","HOMEM"
"250400905000389","1","181","68","249","72.690763052208840","27.3092369477911630","HOMEM"
"250400905000390","1","141","87","228","61.842105263157900","38.1578947368421000","HOMEM"
"250400905000391","1","116","143","259","44.787644787644790","55.2123552123552100","MULHER"
"250400905000392","1","61","148","209","29.186602870813400","70.8133971291866000","MULHER"
"250400905000393","1","149","74","223","66.816143497757850","33.1838565022421500","HOMEM"
"250400905000394","1","91","102","193","47.150259067357510","52.8497409326424900","MULHER"
"250400905000395","1","185","99","284","65.140845070422530","34.8591549295774640","HOMEM"
"250400905000396","1","157","82","239","65.690376569037650","34.3096234309623400","HOMEM"
"250400905000397","1","139","87","226","61.504424778761060","38.4955752212389400","HOMEM"
"250400905000398","1","199","78","277","71.841155234657040","28.1588447653429600","HOMEM"
"250400905000399","1","131","73","204","64.215686274509800","35.7843137254901900","HOMEM"
"250400905000400","1","51","21","72","70.833333333333330","29.1666666666666680","HOMEM"
"250400905000401","1","109","54","163","66.871165644171780","33.1288343558282200","HOMEM"
"250400905000402","1","128","41","169","75.739644970414200","24.2603550295858000","HOMEM"
"250400905000403","1","60","53","113","53.097345132743364","46.9026548672566360","HOMEM"
"250400905000404","1","88","113","201","43.781094527363190","56.2189054726368100","MULHER"
"250400905000405","1","80","40","120","66.666666666666670","33.3333333333333360","HOMEM"
"250400905000406","1","98","45","143","68.531468531468530","31.4685314685314700","HOMEM"
"250400905000407","1","56","43","99","56.565656565656570","43.4343434343434300","HOMEM"
"250400905000408","1","113","80","193","58.549222797927460","41.4507772020725400","HOMEM"
"250400905000409","1","84","56","140","60.000000000000000","40.0000000000000000","HOMEM"
"250400905000410","1","141","91","232","60.775862068965516","39.2241379310344840","HOMEM"
"250400905000411","1","190","97","287","66.202090592334500","33.7979094076655100","HOMEM"
"250400905000412","1","200","141","341","58.651026392961874","41.3489736070381260","HOMEM"
"250400905000413","1","133","55","188","70.744680851063830","29.2553191489361700","HOMEM"
"250400905000414","1","69","23","92","75.000000000000000","25.0000000000000000","HOMEM"
"250400905000415","1","118","78","196","60.204081632653065","39.7959183673469350","HOMEM"
"250400905000416","1","53","160","213","24.882629107981220","75.1173708920187800","MULHER"
"250400905000417","1","100","62","162","61.728395061728390","38.2716049382716100","HOMEM"
"250400905000418","1","154","90","244","63.114754098360656","36.8852459016393440","HOMEM"
"250400905000419","1","131","68","199","65.829145728643210","34.1708542713567800","HOMEM"
"250400905000420","1","97","102","199","48.743718592964825","51.2562814070351750","MULHER"
"250400905000421","1","142","39","181","78.453038674033150","21.5469613259668500","HOMEM"
"250400905000422","1","119","117","236","50.423728813559320","49.5762711864406800","HOMEM"
"250400905000423","1","85","75","160","53.125000000000000","46.8750000000000000","HOMEM"
"250400905000424","1","124","70","194","63.917525773195880","36.0824742268041200","HOMEM"
"250400905000425","1","131","73","204","64.215686274509800","35.7843137254901900","HOMEM"
"250400905000426","1","121","114","235","51.489361702127660","48.5106382978723400","HOMEM"
"250400905000427","1","109","113","222","49.099099099099100","50.9009009009009000","MULHER"
"250400905000428","1","69","118","187","36.898395721925134","63.1016042780748660","MULHER"
"250400905000429","1","155","96","251","61.752988047808760","38.2470119521912400","HOMEM"
"250400905000430","1","136","74","210","64.761904761904760","35.2380952380952400","HOMEM"
"250400905000431","1","187","52","239","78.242677824267790","21.7573221757322170","HOMEM"
"250400905000432","1","28","37","65","43.076923076923080","56.9230769230769200","MULHER"
"250400905000433","1","370","159","529","69.943289224952740","30.0567107750472570","HOMEM"
"250400905000434","4","8","1","9","88.888888888888890","11.1111111111111100","HOMEM"
"250400905000435","1","39","4","43","90.697674418604650","9.3023255813953500","HOMEM"
"250400905000438","1","41","13","54","75.925925925925920","24.0740740740740730","HOMEM"
"250400905000439","1","37","42","79","46.835443037974684","53.1645569620253160","MULHER"
"250400905000440","1","90","54","144","62.500000000000000","37.5000000000000000","HOMEM"
"250400905000441","1","132","102","234","56.410256410256410","43.5897435897435900","HOMEM"
"250400905000442","1","76","55","131","58.015267175572520","41.9847328244274800","HOMEM"
"250400905000443","1","96","85","181","53.038674033149170","46.9613259668508300","HOMEM"
"250400905000444","1","41","148","189","21.693121693121693","78.3068783068783000","MULHER"
"250400905000445","1","52","27","79","65.822784810126580","34.1772151898734150","HOMEM"
"250400905000446","1","131","72","203","64.532019704433500","35.4679802955665050","HOMEM"
"250400905000447","1","44","26","70","62.857142857142854","37.1428571428571460","HOMEM"
"250400905000448","1","119","62","181","65.745856353591170","34.2541436464088400","HOMEM"
"250400905000449","1","67","43","110","60.909090909090910","39.0909090909090900","HOMEM"
"250400915000001","1","41","14","55","74.545454545454550","25.4545454545454530","HOMEM"
"250400915000002","8","130","74","204","63.725490196078430","36.2745098039215700","HOMEM"
"250400915000003","8","56","215","271","20.664206642066420","79.3357933579335800","MULHER"
"250400915000004","8","259","95","354","73.163841807909600","26.8361581920903940","HOMEM"
"250400915000005","8","142","42","184","77.173913043478270","22.8260869565217400","HOMEM"
"250400915000006","5","51","19","70","72.857142857142860","27.1428571428571420","HOMEM"
"250400920000001","1","144","76","220","65.454545454545450","34.5454545454545500","HOMEM"
"250400920000002","1","52","173","225","23.111111111111110","76.8888888888888900","MULHER"
"250400920000003","1","72","130","202","35.643564356435650","64.3564356435643500","MULHER"
"250400920000004","1","148","123","271","54.612546125461260","45.3874538745387400","HOMEM"
"250400920000005","8","112","30","142","78.873239436619710","21.1267605633802800","HOMEM"
"250400920000006","8","76","40","116","65.517241379310350","34.4827586206896600","HOMEM"
"250400920000007","8","48","59","107","44.859813084112150","55.1401869158878500","MULHER"
"250400920000008","8","101","20","121","83.471074380165290","16.5289256198347100","HOMEM"
"250400920000009","8","155","56","211","73.459715639810430","26.5402843601895740","HOMEM"
"250400920000010","4","12","9","21","57.142857142857146","42.8571428571428540","HOMEM"
"250400920000011","1","125","117","242","51.652892561983470","48.3471074380165300","HOMEM"
"250400920000012","1","133","94","227","58.590308370044056","41.4096916299559440","HOMEM"
"250400920000013","1","81","49","130","62.307692307692310","37.6923076923076900","HOMEM"
"250400925000001","1","243","132","375","64.800000000000000","35.2000000000000000","HOMEM"
"250400925000002","1","143","75","218","65.596330275229360","34.4036697247706440","HOMEM"
"250400925000003","1","162","101","263","61.596958174904940","38.4030418250950600","HOMEM"
"250400925000004","1","213","106","319","66.771159874608140","33.2288401253918500","HOMEM"
"250400925000005","1","72","72","144","50.000000000000000","50.0000000000000000","IGUAL"
"250400925000006","8","43","23","66","65.151515151515160","34.8484848484848500","HOMEM"
"250400925000007","4","28","23","51","54.901960784313720","45.0980392156862800","HOMEM"
"250400925000008","8","113","53","166","68.072289156626510","31.9277108433734930","HOMEM"
"250400925000009","8","60","31","91","65.934065934065930","34.0659340659340660","HOMEM"
"250400925000010","8","170","44","214","79.439252336448600","20.5607476635514030","HOMEM"
"250400925000011","8","117","31","148","79.054054054054050","20.9459459459459470","HOMEM"
"250400925000012","8","72","25","97","74.226804123711350","25.7731958762886600","HOMEM"
"250400925000013","8","96","32","128","75.000000000000000","25.0000000000000000","HOMEM"
"250400925000014","8","42","125","167","25.149700598802394","74.8502994011976000","MULHER"
"250400925000015","5","97","48","145","66.896551724137940","33.1034482758620700","HOMEM"
"250400925000016","4","260","102","362","71.823204419889500","28.1767955801104970","HOMEM"
"250400925000017","5","95","35","130","73.076923076923080","26.9230769230769230","HOMEM"
"250400925000018","1","177","57","234","75.641025641025640","24.3589743589743580","HOMEM"
"250400925000019","1","182","84","266","68.421052631578950","31.5789473684210500","HOMEM"
"250400925000020","1","103","72","175","58.857142857142854","41.1428571428571460","HOMEM"
"250403305000001","1","134","65","199","67.336683417085420","32.6633165829145750","HOMEM"
"250403305000002","1","109","70","179","60.893854748603350","39.1061452513966500","HOMEM"
"250403305000003","8","61","26","87","70.114942528735630","29.8850574712643680","HOMEM"
"250403305000004","1","60","98","158","37.974683544303800","62.0253164556962000","MULHER"
"250403305000005","1","126","88","214","58.878504672897190","41.1214953271028100","HOMEM"
"250403305000006","1","94","64","158","59.493670886075950","40.5063291139240500","HOMEM"
"250403305000007","5","192","75","267","71.910112359550570","28.0898876404494370","HOMEM"
"250403315000001","1","125","47","172","72.674418604651170","27.3255813953488380","HOMEM"
"250403315000002","8","11","16","27","40.740740740740740","59.2592592592592600","MULHER"
"250407405000001","1","139","91","230","60.434782608695650","39.5652173913043500","HOMEM"
"250407405000002","1","45","116","161","27.950310559006212","72.0496894409937900","MULHER"
"250407405000003","8","103","33","136","75.735294117647060","24.2647058823529420","HOMEM"
"250407405000004","8","113","40","153","73.856209150326790","26.1437908496732020","HOMEM"
"250407405000005","8","98","36","134","73.134328358208960","26.8656716417910460","HOMEM"
"250407405000006","8","105","104","209","50.239234449760765","49.7607655502392350","HOMEM"
"250407405000007","8","17","43","60","28.333333333333332","71.6666666666666700","MULHER"
"250407405000008","1","58","50","108","53.703703703703700","46.2962962962963000","HOMEM"
"250410805000001","1","67","134","201","33.333333333333336","66.6666666666666700","MULHER"
"250410805000002","8","152","25","177","85.875706214689260","14.1242937853107350","HOMEM"
"250410805000003","1","78","134","212","36.792452830188680","63.2075471698113200","MULHER"
"250415705000001","1","141","156","297","47.474747474747474","52.5252525252525260","MULHER"
"250415705000002","1","170","123","293","58.020477815699660","41.9795221843003400","HOMEM"
"250415705000003","1","107","57","164","65.243902439024400","34.7560975609756100","HOMEM"
"250415705000004","8","17","55","72","23.611111111111110","76.3888888888888900","MULHER"
"250415705000005","8","103","176","279","36.917562724014340","63.0824372759856600","MULHER"
"250415705000006","8","194","24","218","88.990825688073400","11.0091743119266050","HOMEM"
"250415705000007","8","24","11","35","68.571428571428570","31.4285714285714270","HOMEM"
"250415705000008","8","202","74","276","73.188405797101450","26.8115942028985500","HOMEM"
"250415705000009","8","55","9","64","85.937500000000000","14.0625000000000000","HOMEM"
"250415705000010","1","175","74","249","70.281124497991970","29.7188755020080320","HOMEM"
"250420705000001","1","109","78","187","58.288770053475936","41.7112299465240640","HOMEM"
"250420705000002","1","120","79","199","60.301507537688444","39.6984924623115560","HOMEM"
"250420705000003","8","65","11","76","85.526315789473680","14.4736842105263150","HOMEM"
"250420705000004","8","152","26","178","85.393258426966300","14.6067415730337070","HOMEM"
"250420705000005","8","83","34","117","70.940170940170940","29.0598290598290600","HOMEM"
"250420705000006","1","159","91","250","63.600000000000000","36.4000000000000000","HOMEM"
"250420705000007","1","89","47","136","65.441176470588230","34.5588235294117700","HOMEM"
"250420710000001","1","25","15","40","62.500000000000000","37.5000000000000000","HOMEM"
"250420710000002","8","109","15","124","87.903225806451620","12.0967741935483880","HOMEM"
"250430605000001","1","162","102","264","61.363636363636370","38.6363636363636300","HOMEM"
"250430605000002","1","107","75","182","58.791208791208790","41.2087912087912100","HOMEM"
"250430605000003","1","145","112","257","56.420233463035020","43.5797665369649800","HOMEM"
"250430605000004","1","133","91","224","59.375000000000000","40.6250000000000000","HOMEM"
"250430605000005","1","77","35","112","68.750000000000000","31.2500000000000000","HOMEM"
"250430605000006","1","109","140","249","43.775100401606420","56.2248995983935800","MULHER"
"250430605000007","1","110","82","192","57.291666666666664","42.7083333333333360","HOMEM"
"250430605000008","1","168","113","281","59.786476868327405","40.2135231316725950","HOMEM"
"250430605000009","1","190","105","295","64.406779661016960","35.5932203389830500","HOMEM"
"250430605000010","1","183","121","304","60.197368421052630","39.8026315789473700","HOMEM"
"250430605000011","1","167","48","215","77.674418604651170","22.3255813953488380","HOMEM"
"250430605000012","1","163","69","232","70.258620689655170","29.7413793103448300","HOMEM"
"250430605000013","1","230","141","371","61.994609164420490","38.0053908355795100","HOMEM"
"250430605000014","1","237","125","362","65.469613259668500","34.5303867403314940","HOMEM"
"250430605000015","1","147","123","270","54.444444444444440","45.5555555555555600","HOMEM"
"250430605000016","1","135","61","196","68.877551020408160","31.1224489795918370","HOMEM"
"250430605000017","1","85","73","158","53.797468354430380","46.2025316455696200","HOMEM"
"250430605000018","8","67","16","83","80.722891566265060","19.2771084337349400","HOMEM"
"250430605000019","8","132","69","201","65.671641791044780","34.3283582089552200","HOMEM"
"250430605000020","8","137","29","166","82.530120481927710","17.4698795180722900","HOMEM"
"250430605000021","8","64","61","125","51.200000000000000","48.8000000000000000","HOMEM"
"250430605000022","8","148","26","174","85.057471264367820","14.9425287356321840","HOMEM"
"250430605000023","8","135","28","163","82.822085889570560","17.1779141104294480","HOMEM"
"250430605000024","5","47","15","62","75.806451612903230","24.1935483870967760","HOMEM"
"250430605000025","5","25","11","36","69.444444444444440","30.5555555555555570","HOMEM"
"250430605000026","1","163","173","336","48.511904761904760","51.4880952380952400","MULHER"
"250430605000027","1","176","47","223","78.923766816143500","21.0762331838565020","HOMEM"
"250430605000028","1","98","76","174","56.321839080459770","43.6781609195402300","HOMEM"
"250430605000029","1","155","92","247","62.753036437246960","37.2469635627530400","HOMEM"
"250430605000030","1","103","27","130","79.230769230769230","20.7692307692307700","HOMEM"
"250430605000031","1","143","65","208","68.750000000000000","31.2500000000000000","HOMEM"
"250430605000032","1","165","72","237","69.620253164556960","30.3797468354430360","HOMEM"
"250430605000033","1","141","114","255","55.294117647058826","44.7058823529411740","HOMEM"
"250430610000001","1","76","35","111","68.468468468468470","31.5315315315315300","HOMEM"
"250430610000002","8","42","3","45","93.333333333333330","6.6666666666666670","HOMEM"
"250430610000003","8","133","57","190","70.000000000000000","30.0000000000000000","HOMEM"
"250430610000004","8","42","9","51","82.352941176470600","17.6470588235294130","HOMEM"
"250430610000005","8","117","20","137","85.401459854014600","14.5985401459854010","HOMEM"
"250430610000006","8","65","12","77","84.415584415584420","15.5844155844155840","HOMEM"
"250430610000007","5","45","21","66","68.181818181818190","31.8181818181818170","HOMEM"
"250430625000001","1","48","20","68","70.588235294117650","29.4117647058823500","HOMEM"
"250430625000002","8","82","14","96","85.416666666666670","14.5833333333333340","HOMEM"
"250430625000003","8","71","6","77","92.207792207792210","7.7922077922077920","HOMEM"
"250430625000004","8","69","19","88","78.409090909090900","21.5909090909090900","HOMEM"
"250430625000005","8","36","19","55","65.454545454545450","34.5454545454545500","HOMEM"
"250430625000006","8","72","10","82","87.804878048780500","12.1951219512195120","HOMEM"
"250430625000007","5","80","20","100","80.000000000000000","20.0000000000000000","HOMEM"
"250435505000001","1","185","129","314","58.917197452229300","41.0828025477707000","HOMEM"
"250435505000002","8","191","43","234","81.623931623931630","18.3760683760683750","HOMEM"
"250435505000003","8","150","46","196","76.530612244897950","23.4693877551020400","HOMEM"
"250435505000004","8","122","59","181","67.403314917127080","32.5966850828729300","HOMEM"
"250435505000005","5","63","36","99","63.636363636363630","36.3636363636363700","HOMEM"
"250435505000006","8","105","17","122","86.065573770491810","13.9344262295081980","HOMEM"
"250435505000007","5","141","42","183","77.049180327868850","22.9508196721311460","HOMEM"
"250440505000001","1","148","86","234","63.247863247863250","36.7521367521367500","HOMEM"
"250440505000002","1","183","116","299","61.204013377926420","38.7959866220735800","HOMEM"
"250440505000003","1","222","85","307","72.312703583061890","27.6872964169381100","HOMEM"
"250440505000004","1","178","174","352","50.568181818181820","49.4318181818181800","HOMEM"
"250440505000005","1","269","124","393","68.447837150127230","31.5521628498727720","HOMEM"
"250440505000006","1","260","114","374","69.518716577540100","30.4812834224598920","HOMEM"
"250440505000007","1","155","140","295","52.542372881355930","47.4576271186440700","HOMEM"
"250440505000008","1","176","111","287","61.324041811846690","38.6759581881533100","HOMEM"
"250440505000009","1","155","92","247","62.753036437246960","37.2469635627530400","HOMEM"
"250440505000010","1","139","76","215","64.651162790697670","35.3488372093023240","HOMEM"
"250440505000011","8","99","13","112","88.392857142857140","11.6071428571428580","HOMEM"
"250440505000012","8","68","22","90","75.555555555555560","24.4444444444444430","HOMEM"
"250440505000013","8","205","24","229","89.519650655021830","10.4803493449781660","HOMEM"
"250440505000014","8","115","17","132","87.121212121212120","12.8787878787878790","HOMEM"
"250440505000015","8","77","24","101","76.237623762376230","23.7623762376237620","HOMEM"
"250440505000016","8","163","16","179","91.061452513966490","8.9385474860335190","HOMEM"
"250440505000017","8","88","10","98","89.795918367346940","10.2040816326530610","HOMEM"
"250440505000018","8","255","23","278","91.726618705035970","8.2733812949640290","HOMEM"
"250440505000019","8","26","1","27","96.296296296296290","3.7037037037037037","HOMEM"
"250440505000020","1","162","73","235","68.936170212765960","31.0638297872340400","HOMEM"
"250440510000001","1","4","4","8","50.000000000000000","50.0000000000000000","IGUAL"
"250440510000002","8","26","40","66","39.393939393939390","60.6060606060606100","MULHER"
"250440510000003","8","137","22","159","86.163522012578610","13.8364779874213840","HOMEM"
"250440515000001","1","39","16","55","70.909090909090900","29.0909090909090900","HOMEM"
"250440515000002","8","95","19","114","83.333333333333330","16.6666666666666680","HOMEM"
"250440515000003","8","114","65","179","63.687150837988824","36.3128491620111760","HOMEM"
"250440515000004","5","15","32","47","31.914893617021278","68.0851063829787200","MULHER"
"250450405000001","1","131","66","197","66.497461928934020","33.5025380710659900","HOMEM"
"250450405000002","1","99","120","219","45.205479452054796","54.7945205479452040","MULHER"
"250450405000003","1","129","84","213","60.563380281690144","39.4366197183098560","HOMEM"
"250450405000004","8","68","7","75","90.666666666666670","9.3333333333333340","HOMEM"
"250450405000005","8","54","13","67","80.597014925373130","19.4029850746268660","HOMEM"
"250450405000006","8","121","17","138","87.681159420289860","12.3188405797101450","HOMEM"
"250450405000007","8","178","85","263","67.680608365019010","32.3193916349809900","HOMEM"
"250450405000008","1","181","93","274","66.058394160583940","33.9416058394160560","HOMEM"
"250450405000009","1","167","98","265","63.018867924528300","36.9811320754717000","HOMEM"
"250450405000010","1","72","108","180","40.000000000000000","60.0000000000000000","MULHER"
"250460305000001","1","142","106","248","57.258064516129030","42.7419354838709700","HOMEM"
"250460305000002","1","318","108","426","74.647887323943660","25.3521126760563400","HOMEM"
"250460305000003","1","58","31","89","65.168539325842700","34.8314606741573060","HOMEM"
"250460305000004","1","122","79","201","60.696517412935320","39.3034825870646800","HOMEM"
"250460305000005","1","119","52","171","69.590643274853800","30.4093567251462000","HOMEM"
"250460305000006","1","65","138","203","32.019704433497540","67.9802955665024600","MULHER"
"250460305000007","4","84","22","106","79.245283018867920","20.7547169811320770","HOMEM"
"250460305000008","4","63","19","82","76.829268292682930","23.1707317073170740","HOMEM"
"250460305000009","8","89","21","110","80.909090909090900","19.0909090909090900","HOMEM"
"250460305000010","8","154","91","245","62.857142857142854","37.1428571428571460","HOMEM"
"250460305000011","5","95","23","118","80.508474576271180","19.4915254237288130","HOMEM"
"250460305000012","5","121","66","187","64.705882352941170","35.2941176470588260","HOMEM"
"250460305000013","8","0","0","0",NULL,NULL,NULL
"250460305000014","8","92","35","127","72.440944881889760","27.5590551181102370","HOMEM"
"250460305000015","8","38","7","45","84.444444444444440","15.5555555555555550","HOMEM"
"250460305000016","8","53","8","61","86.885245901639350","13.1147540983606560","HOMEM"
"250460305000017","1","174","105","279","62.365591397849464","37.6344086021505360","HOMEM"
"250460305000018","1","90","141","231","38.961038961038960","61.0389610389610400","MULHER"
"250460305000019","1","115","66","181","63.535911602209940","36.4640883977900600","HOMEM"
"250460305000020","1","0","0","0",NULL,NULL,NULL
"250460305000021","4","52","14","66","78.787878787878780","21.2121212121212100","HOMEM"
"250460305000022","4","74","104","178","41.573033707865170","58.4269662921348300","MULHER"
"250460305000023","1","125","71","196","63.775510204081634","36.2244897959183660","HOMEM"
"250460305000024","1","49","17","66","74.242424242424250","25.7575757575757580","HOMEM"
"250460305000025","1","52","113","165","31.515151515151516","68.4848484848484800","MULHER"
"250460305000026","1","127","47","174","72.988505747126440","27.0114942528735650","HOMEM"
"250460305000027","1","105","64","169","62.130177514792900","37.8698224852071000","HOMEM"
"250460305000028","1","112","50","162","69.135802469135800","30.8641975308641960","HOMEM"
"250460305000029","1","154","128","282","54.609929078014180","45.3900709219858200","HOMEM"
"250460305000030","1","63","25","88","71.590909090909100","28.4090909090909100","HOMEM"
"250460305000031","1","51","17","68","75.000000000000000","25.0000000000000000","HOMEM"
"250460305000032","8","86","60","146","58.904109589041100","41.0958904109589000","HOMEM"
"250460305000033","5","88","79","167","52.694610778443110","47.3053892215568900","HOMEM"
"250460305000034","5","98","81","179","54.748603351955310","45.2513966480446900","HOMEM"
"250460316000001","1","27","11","38","71.052631578947370","28.9473684210526300","HOMEM"
"250460316000002","1","26","21","47","55.319148936170215","44.6808510638297850","HOMEM"
"250460316000003","1","42","17","59","71.186440677966100","28.8135593220339000","HOMEM"
"250460316000004","1","12","1","13","92.307692307692300","7.6923076923076925","HOMEM"
"250460316000005","1","3","4","7","42.857142857142854","57.1428571428571460","MULHER"
"250460316000006","1","51","13","64","79.687500000000000","20.3125000000000000","HOMEM"
"250460316000007","1","77","55","132","58.333333333333336","41.6666666666666640","HOMEM"
"250460316000008","1","41","24","65","63.076923076923080","36.9230769230769200","HOMEM"
"250460316000009","1","80","19","99","80.808080808080800","19.1919191919191900","HOMEM"
"250470205000001","1","126","89","215","58.604651162790695","41.3953488372093050","HOMEM"
"250470205000002","1","102","207","309","33.009708737864080","66.9902912621359300","MULHER"
"250470205000003","1","227","194","421","53.919239904988125","46.0807600950118750","HOMEM"
"250470205000004","8","69","47","116","59.482758620689660","40.5172413793103400","HOMEM"
"250470205000005","8","61","21","82","74.390243902439020","25.6097560975609750","HOMEM"
"250470205000006","8","42","14","56","75.000000000000000","25.0000000000000000","HOMEM"
"250470205000007","8","82","61","143","57.342657342657340","42.6573426573426600","HOMEM"
"250470205000008","8","40","76","116","34.482758620689660","65.5172413793103500","MULHER"
"250470205000009","4","10","10","20","50.000000000000000","50.0000000000000000","IGUAL"
"250480105000001","1","89","93","182","48.901098901098900","51.0989010989011000","MULHER"
"250480105000002","1","135","88","223","60.538116591928250","39.4618834080717500","HOMEM"
"250480105000003","1","151","86","237","63.713080168776370","36.2869198312236300","HOMEM"
"250480105000004","1","178","127","305","58.360655737704920","41.6393442622950800","HOMEM"
"250480105000005","1","177","95","272","65.073529411764710","34.9264705882353000","HOMEM"
"250480105000006","1","89","88","177","50.282485875706215","49.7175141242937850","HOMEM"
"250480105000007","1","114","94","208","54.807692307692310","45.1923076923076900","HOMEM"
"250480105000008","1","78","52","130","60.000000000000000","40.0000000000000000","HOMEM"
"250480105000009","8","45","2","47","95.744680851063830","4.2553191489361700","HOMEM"
"250480105000010","8","121","7","128","94.531250000000000","5.4687500000000000","HOMEM"
"250480105000011","8","222","57","279","79.569892473118270","20.4301075268817200","HOMEM"
"250480105000012","8","235","30","265","88.679245283018870","11.3207547169811310","HOMEM"
"250480105000013","8","176","21","197","89.340101522842640","10.6598984771573600","HOMEM"
"250480105000014","8","70","15","85","82.352941176470600","17.6470588235294130","HOMEM"
"250480105000015","1","204","80","284","71.830985915492960","28.1690140845070440","HOMEM"
"250480105000016","1","172","95","267","64.419475655430720","35.5805243445692900","HOMEM"
"250480105000017","1","138","70","208","66.346153846153840","33.6538461538461500","HOMEM"
"250480105000018","1","77","134","211","36.492890995260666","63.5071090047393340","MULHER"
"250480105000019","1","192","126","318","60.377358490566040","39.6226415094339600","HOMEM"
"250480105000020","1","122","67","189","64.550264550264540","35.4497354497354500","HOMEM"
"250480105000021","1","87","52","139","62.589928057553955","37.4100719424460450","HOMEM"
"250485005000001","1","152","116","268","56.716417910447760","43.2835820895522400","HOMEM"
"250485005000002","8","120","40","160","75.000000000000000","25.0000000000000000","HOMEM"
"250485005000003","8","48","14","62","77.419354838709680","22.5806451612903240","HOMEM"
"250485005000004","8","70","28","98","71.428571428571430","28.5714285714285730","HOMEM"
"250490005000001","1","99","74","173","57.225433526011564","42.7745664739884360","HOMEM"
"250490005000002","1","187","167","354","52.824858757062145","47.1751412429378550","HOMEM"
"250490005000003","1","281","201","482","58.298755186721990","41.7012448132780100","HOMEM"
"250490005000004","3","315","165","480","65.625000000000000","34.3750000000000000","HOMEM"
"250490005000005","3","181","211","392","46.173469387755105","53.8265306122448950","MULHER"
"250490005000006","8","134","30","164","81.707317073170730","18.2926829268292700","HOMEM"
"250490005000007","8","120","41","161","74.534161490683230","25.4658385093167700","HOMEM"
"250490005000008","8","41","12","53","77.358490566037730","22.6415094339622630","HOMEM"
"250490005000009","8","90","37","127","70.866141732283470","29.1338582677165370","HOMEM"
"250490005000010","8","54","8","62","87.096774193548380","12.9032258064516120","HOMEM"
"250490005000011","8","231","65","296","78.040540540540550","21.9594594594594600","HOMEM"
"250490005000012","8","105","42","147","71.428571428571430","28.5714285714285730","HOMEM"
"250490005000013","8","14","9","23","60.869565217391305","39.1304347826086950","HOMEM"
"250490005000014","8","146","44","190","76.842105263157890","23.1578947368421060","HOMEM"
"250490005000015","8","30","5","35","85.714285714285710","14.2857142857142860","HOMEM"
"250490005000016","8","233","61","294","79.251700680272110","20.7482993197278900","HOMEM"
"250490005000017","1","47","24","71","66.197183098591550","33.8028169014084500","HOMEM"
"250490005000018","5","51","23","74","68.918918918918920","31.0810810810810800","HOMEM"
"250490005000019","5","115","24","139","82.733812949640280","17.2661870503597100","HOMEM"
"250490005000020","5","160","59","219","73.059360730593610","26.9406392694063930","HOMEM"
"250490005000021","5","204","61","265","76.981132075471690","23.0188679245283000","HOMEM"
"250500605000001","1","165","143","308","53.571428571428570","46.4285714285714300","HOMEM"
"250500605000002","1","114","127","241","47.302904564315355","52.6970954356846450","MULHER"
"250500605000003","1","172","161","333","51.651651651651655","48.3483483483483450","HOMEM"
"250500605000004","1","120","114","234","51.282051282051285","48.7179487179487150","HOMEM"
"250500605000005","1","196","147","343","57.142857142857146","42.8571428571428540","HOMEM"
"250500605000006","8","96","132","228","42.105263157894740","57.8947368421052600","MULHER"
"250500605000007","8","41","20","61","67.213114754098360","32.7868852459016400","HOMEM"
"250500605000008","8","111","25","136","81.617647058823540","18.3823529411764700","HOMEM"
"250500605000009","8","81","9","90","90.000000000000000","10.0000000000000000","HOMEM"
"250500605000010","8","21","4","25","84.000000000000000","16.0000000000000000","HOMEM"
"250500605000011","8","19","9","28","67.857142857142860","32.1428571428571460","HOMEM"
"250510505000001","1","58","51","109","53.211009174311926","46.7889908256880740","HOMEM"
"250510505000002","1","109","80","189","57.671957671957670","42.3280423280423300","HOMEM"
"250510505000003","1","175","131","306","57.189542483660134","42.8104575163398660","HOMEM"
"250510505000004","1","113","56","169","66.863905325443780","33.1360946745562100","HOMEM"
"250510505000005","1","114","129","243","46.913580246913580","53.0864197530864200","MULHER"
"250510505000006","1","84","132","216","38.888888888888886","61.1111111111111140","MULHER"
"250510505000007","1","79","70","149","53.020134228187920","46.9798657718120800","HOMEM"
"250510505000008","1","141","91","232","60.775862068965516","39.2241379310344840","HOMEM"
"250510505000009","1","104","60","164","63.414634146341460","36.5853658536585400","HOMEM"
"250510505000010","1","111","84","195","56.923076923076920","43.0769230769230800","HOMEM"
"250510505000011","1","89","88","177","50.282485875706215","49.7175141242937850","HOMEM"
"250510505000012","8","92","53","145","63.448275862068970","36.5517241379310300","HOMEM"
"250510505000013","8","128","42","170","75.294117647058830","24.7058823529411780","HOMEM"
"250510505000014","8","88","21","109","80.733944954128450","19.2660550458715600","HOMEM"
"250510505000015","8","52","14","66","78.787878787878780","21.2121212121212100","HOMEM"
"250510505000016","8","80","4","84","95.238095238095240","4.7619047619047620","HOMEM"
"250510505000017","8","37","12","49","75.510204081632650","24.4897959183673460","HOMEM"
"250510505000018","8","88","19","107","82.242990654205610","17.7570093457943940","HOMEM"
"250510505000019","8","80","23","103","77.669902912621350","22.3300970873786400","HOMEM"
"250510505000020","8","83","28","111","74.774774774774770","25.2252252252252270","HOMEM"
"250510505000021","8","61","18","79","77.215189873417730","22.7848101265822800","HOMEM"
"250510505000022","5","20","6","26","76.923076923076920","23.0769230769230770","HOMEM"
"250510505000023","1","82","71","153","53.594771241830070","46.4052287581699300","HOMEM"
"250510505000024","1","150","82","232","64.655172413793110","35.3448275862069000","HOMEM"
"250510505000025","1","97","94","191","50.785340314136130","49.2146596858638700","HOMEM"
"250510505000026","1","79","136","215","36.744186046511630","63.2558139534883700","MULHER"
"250510505000027","1","76","72","148","51.351351351351354","48.6486486486486460","HOMEM"
"250510505000028","1","118","121","239","49.372384937238490","50.6276150627615100","MULHER"
"250510505000029","1","116","77","193","60.103626943005180","39.8963730569948200","HOMEM"
"250510505000030","1","112","122","234","47.863247863247864","52.1367521367521360","MULHER"
"250510505000031","1","66","166","232","28.448275862068964","71.5517241379310300","MULHER"
"250510510000001","1","36","18","54","66.666666666666670","33.3333333333333360","HOMEM"
"250510510000002","8","92","8","100","92.000000000000000","8.0000000000000000","HOMEM"
"250510510000003","8","43","18","61","70.491803278688520","29.5081967213114740","HOMEM"
"250510510000004","8","146","15","161","90.683229813664600","9.3167701863354040","HOMEM"
"250510510000005","8","112","29","141","79.432624113475170","20.5673758865248200","HOMEM"
"250510510000006","8","27","9","36","75.000000000000000","25.0000000000000000","HOMEM"
"250510510000007","8","159","41","200","79.500000000000000","20.5000000000000000","HOMEM"
"250510510000008","8","68","13","81","83.950617283950620","16.0493827160493830","HOMEM"
"250520405000001","1","133","153","286","46.503496503496510","53.4965034965034900","MULHER"
"250520405000002","1","183","117","300","61.000000000000000","39.0000000000000000","HOMEM"
"250520405000003","1","81","182","263","30.798479087452470","69.2015209125475200","MULHER"
"250520405000004","1","130","95","225","57.777777777777780","42.2222222222222200","HOMEM"
"250520405000005","1","54","160","214","25.233644859813083","74.7663551401869200","MULHER"
"250520405000006","1","170","96","266","63.909774436090224","36.0902255639097760","HOMEM"
"250520405000007","8","119","38","157","75.796178343949040","24.2038216560509550","HOMEM"
"250520405000008","8","155","32","187","82.887700534759360","17.1122994652406430","HOMEM"
"250523805000001","1","196","72","268","73.134328358208960","26.8656716417910460","HOMEM"
"250523805000002","1","221","118","339","65.191740412979360","34.8082595870206500","HOMEM"
"250523805000003","8","123","40","163","75.460122699386500","24.5398773006134970","HOMEM"
"250523805000004","8","67","14","81","82.716049382716050","17.2839506172839500","HOMEM"
"250523805000005","8","7","1","8","87.500000000000000","12.5000000000000000","HOMEM"
"250523805000006","8","44","17","61","72.131147540983600","27.8688524590163950","HOMEM"
"250523805000007","5","81","62","143","56.643356643356650","43.3566433566433500","HOMEM"
"250523805000008","8","15","2","17","88.235294117647060","11.7647058823529420","HOMEM"
"250523805000009","5","80","38","118","67.796610169491530","32.2033898305084800","HOMEM"
"250523805000010","8","108","44","152","71.052631578947370","28.9473684210526300","HOMEM"
"250523805000011","8","12","5","17","70.588235294117650","29.4117647058823500","HOMEM"
"250523805000012","5","95","78","173","54.913294797687860","45.0867052023121400","HOMEM"
"250523805000013","5","52","77","129","40.310077519379846","59.6899224806201540","MULHER"
"250523805000014","5","31","20","51","60.784313725490190","39.2156862745098100","HOMEM"
"250523805000015","5","8","1","9","88.888888888888890","11.1111111111111100","HOMEM"
"250527905000001","1","69","87","156","44.230769230769230","55.7692307692307700","MULHER"
"250527905000002","8","107","46","153","69.934640522875810","30.0653594771241830","HOMEM"
"250527905000003","8","16","67","83","19.277108433734940","80.7228915662650600","MULHER"
"250527905000004","8","92","29","121","76.033057851239680","23.9669421487603300","HOMEM"
"250527905000005","8","115","35","150","76.666666666666670","23.3333333333333320","HOMEM"
"250527905000006","8","74","33","107","69.158878504672900","30.8411214953271000","HOMEM"
"250527905000007","8","97","27","124","78.225806451612900","21.7741935483870960","HOMEM"
"250527905000008","5","80","29","109","73.394495412844040","26.6055045871559630","HOMEM"
"250527905000009","8","104","15","119","87.394957983193280","12.6050420168067220","HOMEM"
"250527905000010","8","41","6","47","87.234042553191490","12.7659574468085100","HOMEM"
"250527905000011","8","52","83","135","38.518518518518520","61.4814814814814800","MULHER"
"250527905000012","8","104","57","161","64.596273291925470","35.4037267080745400","HOMEM"
"250530305000001","1","97","127","224","43.303571428571430","56.6964285714285700","MULHER"
"250530305000002","8","62","69","131","47.328244274809160","52.6717557251908400","MULHER"
"250530305000003","8","41","50","91","45.054945054945060","54.9450549450549400","MULHER"
"250530305000004","8","29","16","45","64.444444444444440","35.5555555555555600","HOMEM"
"250530305000005","1","115","42","157","73.248407643312100","26.7515923566878970","HOMEM"
"250535205000001","1","127","65","192","66.145833333333330","33.8541666666666640","HOMEM"
"250535205000002","8","114","25","139","82.014388489208630","17.9856115107913650","HOMEM"
"250535205000003","8","133","42","175","76.000000000000000","24.0000000000000000","HOMEM"
"250535205000004","8","39","13","52","75.000000000000000","25.0000000000000000","HOMEM"
"250535205000005","8","146","33","179","81.564245810055870","18.4357541899441340","HOMEM"
"250535205000006","8","102","24","126","80.952380952380950","19.0476190476190470","HOMEM"
"250535205000007","8","20","5","25","80.000000000000000","20.0000000000000000","HOMEM"
"250535205000008","1","124","109","233","53.218884120171670","46.7811158798283300","HOMEM"
"250535205000009","1","162","93","255","63.529411764705884","36.4705882352941160","HOMEM"
"250540205000001","1","111","77","188","59.042553191489360","40.9574468085106400","HOMEM"
"250540205000002","1","65","246","311","20.900321543408360","79.0996784565916300","MULHER"
"250540205000003","1","81","63","144","56.250000000000000","43.7500000000000000","HOMEM"
"250540205000004","1","257","175","432","59.490740740740740","40.5092592592592600","HOMEM"
"250540205000005","8","102","82","184","55.434782608695650","44.5652173913043500","HOMEM"
"250540205000006","8","59","36","95","62.105263157894740","37.8947368421052600","HOMEM"
"250540205000007","8","33","60","93","35.483870967741936","64.5161290322580600","MULHER"
"250540205000008","8","119","31","150","79.333333333333330","20.6666666666666680","HOMEM"
"250540205000009","8","151","27","178","84.831460674157300","15.1685393258426960","HOMEM"
"250540205000010","5","66","120","186","35.483870967741936","64.5161290322580600","MULHER"
"250540205000011","1","48","98","146","32.876712328767130","67.1232876712328700","MULHER"
"250540205000012","1","135","70","205","65.853658536585370","34.1463414634146360","HOMEM"
"250550105000001","1","132","80","212","62.264150943396224","37.7358490566037760","HOMEM"
"250550105000002","8","48","194","242","19.834710743801654","80.1652892561983500","MULHER"
"250550105000003","8","174","75","249","69.879518072289160","30.1204819277108450","HOMEM"
"250550105000004","1","167","46","213","78.403755868544610","21.5962441314554000","HOMEM"
"250560005000001","1","159","185","344","46.220930232558140","53.7790697674418600","MULHER"
"250560005000002","1","196","113","309","63.430420711974110","36.5695792880258900","HOMEM"
"250560005000003","1","261","82","343","76.093294460641400","23.9067055393586000","HOMEM"
"250560005000004","8","129","16","145","88.965517241379320","11.0344827586206900","HOMEM"
"250560005000005","8","159","86","245","64.897959183673460","35.1020408163265300","HOMEM"
"250560005000006","8","73","42","115","63.478260869565220","36.5217391304347800","HOMEM"
"250560005000007","8","51","8","59","86.440677966101690","13.5593220338983040","HOMEM"
"250560010000001","1","36","58","94","38.297872340425535","61.7021276595744650","MULHER"
"250560010000002","8","100","10","110","90.909090909090900","9.0909090909090920","HOMEM"
"250570905000001","1","223","87","310","71.935483870967740","28.0645161290322600","HOMEM"
"250570905000002","1","146","82","228","64.035087719298250","35.9649122807017500","HOMEM"
"250570905000003","1","93","173","266","34.962406015037594","65.0375939849624000","MULHER"
"250570905000004","1","112","45","157","71.337579617834400","28.6624203821656070","HOMEM"
"250570905000005","1","146","92","238","61.344537815126050","38.6554621848739500","HOMEM"
"250570905000006","8","121","30","151","80.132450331125820","19.8675496688741720","HOMEM"
"250570905000007","8","112","18","130","86.153846153846160","13.8461538461538470","HOMEM"
"250570905000008","8","45","18","63","71.428571428571430","28.5714285714285730","HOMEM"
"250570905000009","8","67","23","90","74.444444444444440","25.5555555555555570","HOMEM"
"250570905000010","8","103","56","159","64.779874213836480","35.2201257861635200","HOMEM"
"250570905000011","8","202","21","223","90.582959641255600","9.4170403587443940","HOMEM"
"250570905000012","8","62","27","89","69.662921348314610","30.3370786516853920","HOMEM"
"250570905000013","8","114","58","172","66.279069767441850","33.7209302325581400","HOMEM"
"250570905000014","8","86","12","98","87.755102040816330","12.2448979591836730","HOMEM"
"250570905000015","1","149","63","212","70.283018867924530","29.7169811320754700","HOMEM"
"250570905000016","8","88","64","152","57.894736842105260","42.1052631578947400","HOMEM"
"250570905000017","5","52","16","68","76.470588235294120","23.5294117647058840","HOMEM"
"250570905000018","5","36","20","56","64.285714285714290","35.7142857142857150","HOMEM"
"250570905000019","8","67","27","94","71.276595744680850","28.7234042553191500","HOMEM"
"250580805000001","1","170","122","292","58.219178082191780","41.7808219178082200","HOMEM"
"250580805000002","1","104","129","233","44.635193133047210","55.3648068669527900","MULHER"
"250580805000003","1","188","146","334","56.287425149700596","43.7125748502994040","HOMEM"
"250580805000004","8","27","21","48","56.250000000000000","43.7500000000000000","HOMEM"
"250580805000005","8","51","37","88","57.954545454545450","42.0454545454545500","HOMEM"
"250580805000006","8","62","17","79","78.481012658227850","21.5189873417721530","HOMEM"
"250590705000001","1","198","143","341","58.064516129032256","41.9354838709677440","HOMEM"
"250590705000002","8","108","6","114","94.736842105263160","5.2631578947368425","HOMEM"
"250590705000003","8","69","12","81","85.185185185185190","14.8148148148148150","HOMEM"
"250590705000004","8","51","9","60","85.000000000000000","15.0000000000000000","HOMEM"
"250590705000005","1","105","118","223","47.085201793721970","52.9147982062780300","MULHER"
"250600405000001","1","180","142","322","55.900621118012424","44.0993788819875760","HOMEM"
"250600405000002","1","174","185","359","48.467966573816156","51.5320334261838440","MULHER"
"250600405000003","1","116","93","209","55.502392344497610","44.4976076555023900","HOMEM"
"250600405000004","1","80","229","309","25.889967637540455","74.1100323624595500","MULHER"
"250600405000005","1","148","83","231","64.069264069264070","35.9307359307359300","HOMEM"
"250600405000006","1","108","84","192","56.250000000000000","43.7500000000000000","HOMEM"
"250600405000007","1","119","93","212","56.132075471698116","43.8679245283018840","HOMEM"
"250600405000008","1","145","54","199","72.864321608040200","27.1356783919598000","HOMEM"
"250600405000009","1","148","125","273","54.212454212454210","45.7875457875457900","HOMEM"
"250600405000010","1","72","175","247","29.149797570850204","70.8502024291498000","MULHER"
"250600405000011","1","99","58","157","63.057324840764330","36.9426751592356700","HOMEM"
"250600405000012","1","147","107","254","57.874015748031496","42.1259842519685040","HOMEM"
"250600405000013","1","174","87","261","66.666666666666670","33.3333333333333360","HOMEM"
"250600405000014","1","104","92","196","53.061224489795920","46.9387755102040800","HOMEM"
"250600405000015","1","49","170","219","22.374429223744293","77.6255707762557100","MULHER"
"250600405000016","1","190","164","354","53.672316384180790","46.3276836158192100","HOMEM"
"250600405000017","8","148","37","185","80.000000000000000","20.0000000000000000","HOMEM"
"250600405000018","8","96","27","123","78.048780487804880","21.9512195121951240","HOMEM"
"250600405000019","8","28","9","37","75.675675675675680","24.3243243243243230","HOMEM"
"250600405000020","5","199","155","354","56.214689265536720","43.7853107344632800","HOMEM"
"250600405000021","8","34","129","163","20.858895705521473","79.1411042944785200","MULHER"
"250600405000022","8","128","25","153","83.660130718954250","16.3398692810457500","HOMEM"
"250600405000023","8","38","7","45","84.444444444444440","15.5555555555555550","HOMEM"
"250600405000024","8","72","73","145","49.655172413793100","50.3448275862069000","MULHER"
"250600405000025","8","88","30","118","74.576271186440680","25.4237288135593220","HOMEM"
"250600405000026","8","163","43","206","79.126213592233010","20.8737864077669900","HOMEM"
"250600405000027","8","29","127","156","18.589743589743590","81.4102564102564100","MULHER"
"250600405000028","8","221","45","266","83.082706766917300","16.9172932330827060","HOMEM"
"250600405000029","5","35","150","185","18.918918918918920","81.0810810810810800","MULHER"
"250600405000030","8","44","8","52","84.615384615384610","15.3846153846153850","HOMEM"
"250600405000031","8","30","51","81","37.037037037037040","62.9629629629629600","MULHER"
"250600405000032","8","214","45","259","82.625482625482620","17.3745173745173740","HOMEM"
"250600405000033","1","150","75","225","66.666666666666670","33.3333333333333360","HOMEM"
"250600405000034","1","162","50","212","76.415094339622640","23.5849056603773600","HOMEM"
"250600405000035","1","64","180","244","26.229508196721312","73.7704918032786900","MULHER"
"250600405000036","1","142","42","184","77.173913043478270","22.8260869565217400","HOMEM"
"250600405000037","1","199","109","308","64.610389610389600","35.3896103896103900","HOMEM"
"250600405000038","1","88","79","167","52.694610778443110","47.3053892215568900","HOMEM"
"250600405000039","1","168","37","205","81.951219512195120","18.0487804878048760","HOMEM"
"250600405000040","1","53","184","237","22.362869198312236","77.6371308016877600","MULHER"
"250600405000041","1","65","148","213","30.516431924882628","69.4835680751173800","MULHER"
"250600405000042","1","177","63","240","73.750000000000000","26.2500000000000000","HOMEM"
"250600405000043","1","159","98","257","61.867704280155640","38.1322957198443600","HOMEM"
"250600405000044","5","38","45","83","45.783132530120480","54.2168674698795200","MULHER"
"250610305000001","1","148","109","257","57.587548638132300","42.4124513618677000","HOMEM"
"250610305000002","1","80","83","163","49.079754601226995","50.9202453987730050","MULHER"
"250610305000003","1","128","124","252","50.793650793650790","49.2063492063492100","HOMEM"
"250610305000004","1","129","112","241","53.526970954356850","46.4730290456431500","HOMEM"
"250610305000005","1","68","106","174","39.080459770114940","60.9195402298850600","MULHER"
"250610305000006","1","173","110","283","61.130742049469966","38.8692579505300340","HOMEM"
"250610305000007","8","194","49","243","79.835390946502060","20.1646090534979400","HOMEM"
"250610305000008","8","158","54","212","74.528301886792450","25.4716981132075480","HOMEM"
"250610305000009","8","104","52","156","66.666666666666670","33.3333333333333360","HOMEM"
"250610305000010","8","87","115","202","43.069306930693070","56.9306930693069300","MULHER"
"250610305000011","8","0","0","0",NULL,NULL,NULL
"250610305000012","8","129","56","185","69.729729729729730","30.2702702702702700","HOMEM"
"250610305000013","8","174","66","240","72.500000000000000","27.5000000000000000","HOMEM"
"250610305000014","8","86","80","166","51.807228915662650","48.1927710843373500","HOMEM"
"250610305000015","8","0","0","0",NULL,NULL,NULL
"250610305000016","8","60","23","83","72.289156626506030","27.7108433734939760","HOMEM"
"250610305000017","8","43","23","66","65.151515151515160","34.8484848484848500","HOMEM"
"250610305000018","1","61","61","122","50.000000000000000","50.0000000000000000","IGUAL"
"250610305000019","1","85","61","146","58.219178082191780","41.7808219178082200","HOMEM"
"250620205000001","1","147","65","212","69.339622641509440","30.6603773584905670","HOMEM"
"250620205000002","1","131","71","202","64.851485148514850","35.1485148514851460","HOMEM"
"250620205000003","8","93","23","116","80.172413793103440","19.8275862068965500","HOMEM"
"250620205000004","8","55","13","68","80.882352941176460","19.1176470588235300","HOMEM"
"250620205000005","8","143","48","191","74.869109947643980","25.1308900523560230","HOMEM"
"250620205000006","1","104","67","171","60.818713450292400","39.1812865497076000","HOMEM"
"250625105000001","1","96","188","284","33.802816901408450","66.1971830985915500","MULHER"
"250625105000002","8","47","31","78","60.256410256410255","39.7435897435897450","HOMEM"
"250625105000003","5","125","69","194","64.432989690721660","35.5670103092783500","HOMEM"
"250625105000004","8","134","53","187","71.657754010695190","28.3422459893048140","HOMEM"
"250625105000005","8","83","89","172","48.255813953488370","51.7441860465116300","MULHER"
"250625105000006","8","133","27","160","83.125000000000000","16.8750000000000000","HOMEM"
"250625105000007","8","131","36","167","78.443113772455090","21.5568862275449100","HOMEM"
"250625105000008","8","99","49","148","66.891891891891890","33.1081081081081050","HOMEM"
"250625105000009","8","170","35","205","82.926829268292680","17.0731707317073180","HOMEM"
"250625105000010","8","63","20","83","75.903614457831320","24.0963855421686760","HOMEM"
"250625105000011","8","89","23","112","79.464285714285710","20.5357142857142850","HOMEM"
"250625105000012","8","41","19","60","68.333333333333330","31.6666666666666680","HOMEM"
"250625105000013","8","63","123","186","33.870967741935480","66.1290322580645100","MULHER"
"250625105000014","8","28","13","41","68.292682926829270","31.7073170731707300","HOMEM"
"250625105000015","8","77","75","152","50.657894736842100","49.3421052631579000","HOMEM"
"250630105000001","1","158","109","267","59.176029962546814","40.8239700374531860","HOMEM"
"250630105000002","1","177","126","303","58.415841584158414","41.5841584158415860","HOMEM"
"250630105000003","1","43","158","201","21.393034825870647","78.6069651741293600","MULHER"
"250630105000004","1","81","40","121","66.942148760330580","33.0578512396694200","HOMEM"
"250630105000005","1","162","100","262","61.832061068702290","38.1679389312977100","HOMEM"
"250630105000006","1","149","81","230","64.782608695652170","35.2173913043478300","HOMEM"
"250630105000007","1","201","116","317","63.406940063091480","36.5930599369085200","HOMEM"
"250630105000008","1","128","87","215","59.534883720930230","40.4651162790697700","HOMEM"
"250630105000009","1","207","85","292","70.890410958904110","29.1095890410958900","HOMEM"
"250630105000010","1","201","68","269","74.721189591078070","25.2788104089219350","HOMEM"
"250630105000011","1","263","97","360","73.055555555555560","26.9444444444444430","HOMEM"
"250630105000012","1","136","57","193","70.466321243523310","29.5336787564766820","HOMEM"
"250630105000013","1","81","45","126","64.285714285714290","35.7142857142857150","HOMEM"
"250630105000014","1","82","49","131","62.595419847328245","37.4045801526717550","HOMEM"
"250630105000015","1","124","156","280","44.285714285714285","55.7142857142857150","MULHER"
"250630105000016","1","139","128","267","52.059925093632955","47.9400749063670450","HOMEM"
"250630105000017","1","127","68","195","65.128205128205120","34.8717948717948700","HOMEM"
"250630105000018","1","118","54","172","68.604651162790700","31.3953488372093000","HOMEM"
"250630105000019","1","140","92","232","60.344827586206900","39.6551724137931000","HOMEM"
"250630105000020","1","202","134","336","60.119047619047620","39.8809523809523800","HOMEM"
"250630105000021","1","257","101","358","71.787709497206700","28.2122905027932940","HOMEM"
"250630105000022","1","133","96","229","58.078602620087340","41.9213973799126600","HOMEM"
"250630105000023","1","139","73","212","65.566037735849050","34.4339622641509400","HOMEM"
"250630105000024","1","123","96","219","56.164383561643840","43.8356164383561600","HOMEM"
"250630105000025","1","196","115","311","63.022508038585210","36.9774919614147900","HOMEM"
"250630105000026","1","298","128","426","69.953051643192500","30.0469483568075120","HOMEM"
"250630105000027","1","111","62","173","64.161849710982660","35.8381502890173400","HOMEM"
"250630105000028","1","266","93","359","74.094707520891360","25.9052924791086350","HOMEM"
"250630105000029","1","233","88","321","72.585669781931460","27.4143302180685350","HOMEM"
"250630105000030","1","294","122","416","70.673076923076920","29.3269230769230770","HOMEM"
"250630105000031","1","125","111","236","52.966101694915250","47.0338983050847500","HOMEM"
"250630105000032","1","217","71","288","75.347222222222230","24.6527777777777800","HOMEM"
"250630105000033","1","154","62","216","71.296296296296290","28.7037037037037020","HOMEM"
"250630105000034","1","103","78","181","56.906077348066300","43.0939226519337000","HOMEM"
"250630105000035","1","180","136","316","56.962025316455694","43.0379746835443060","HOMEM"
"250630105000036","1","151","77","228","66.228070175438600","33.7719298245614040","HOMEM"
"250630105000037","1","175","76","251","69.721115537848600","30.2788844621513960","HOMEM"
"250630105000038","1","173","51","224","77.232142857142860","22.7678571428571420","HOMEM"
"250630105000039","1","113","75","188","60.106382978723400","39.8936170212766000","HOMEM"
"250630105000040","1","151","85","236","63.983050847457626","36.0169491525423740","HOMEM"
"250630105000041","8","28","7","35","80.000000000000000","20.0000000000000000","HOMEM"
"250630105000042","4","59","41","100","59.000000000000000","41.0000000000000000","HOMEM"
"250630105000043","8","37","11","48","77.083333333333330","22.9166666666666680","HOMEM"
"250630105000044","8","97","35","132","73.484848484848480","26.5151515151515160","HOMEM"
"250630105000045","8","132","36","168","78.571428571428570","21.4285714285714270","HOMEM"
"250630105000046","8","31","23","54","57.407407407407405","42.5925925925925950","HOMEM"
"250630105000047","5","135","73","208","64.903846153846160","35.0961538461538500","HOMEM"
"250630105000048","8","68","18","86","79.069767441860460","20.9302325581395370","HOMEM"
"250630105000049","8","100","44","144","69.444444444444440","30.5555555555555570","HOMEM"
"250630105000050","1","110","65","175","62.857142857142854","37.1428571428571460","HOMEM"
"250630105000051","1","203","123","326","62.269938650306750","37.7300613496932500","HOMEM"
"250630105000052","1","98","52","150","65.333333333333330","34.6666666666666640","HOMEM"
"250630105000053","1","123","71","194","63.402061855670105","36.5979381443298950","HOMEM"
"250630105000054","1","134","76","210","63.809523809523810","36.1904761904761900","HOMEM"
"250630105000055","1","158","65","223","70.852017937219730","29.1479820627802700","HOMEM"
"250630105000056","1","130","144","274","47.445255474452550","52.5547445255474500","MULHER"
"250630105000057","1","105","72","177","59.322033898305090","40.6779661016949100","HOMEM"
"250630105000058","1","111","57","168","66.071428571428570","33.9285714285714300","HOMEM"
"250630105000059","1","153","66","219","69.863013698630140","30.1369863013698630","HOMEM"
"250630105000060","1","97","40","137","70.802919708029200","29.1970802919708030","HOMEM"
"250630105000061","1","288","85","373","77.211796246648790","22.7882037533512050","HOMEM"
"250630105000062","1","174","66","240","72.500000000000000","27.5000000000000000","HOMEM"
"250630105000063","1","137","86","223","61.434977578475330","38.5650224215246700","HOMEM"
"250630105000064","1","113","82","195","57.948717948717950","42.0512820512820500","HOMEM"
"250630105000065","1","93","69","162","57.407407407407405","42.5925925925925950","HOMEM"
"250630105000066","1","128","72","200","64.000000000000000","36.0000000000000000","HOMEM"
"250630105000067","1","153","108","261","58.620689655172410","41.3793103448275900","HOMEM"
"250630105000068","1","95","65","160","59.375000000000000","40.6250000000000000","HOMEM"
"250630110000001","1","132","127","259","50.965250965250966","49.0347490347490340","HOMEM"
"250630110000002","8","75","21","96","78.125000000000000","21.8750000000000000","HOMEM"
"250630110000003","8","84","31","115","73.043478260869560","26.9565217391304340","HOMEM"
"250630110000004","8","24","9","33","72.727272727272730","27.2727272727272730","HOMEM"
"250630110000005","8","45","20","65","69.230769230769230","30.7692307692307700","HOMEM"
"250630110000006","8","34","116","150","22.666666666666668","77.3333333333333300","MULHER"
"250630110000007","5","56","23","79","70.886075949367080","29.1139240506329100","HOMEM"
"250630110000008","7","73","23","96","76.041666666666670","23.9583333333333320","HOMEM"
"250630110000009","5","54","24","78","69.230769230769230","30.7692307692307700","HOMEM"
"250630110000010","7","57","25","82","69.512195121951220","30.4878048780487800","HOMEM"
"250640005000001","1","155","123","278","55.755395683453240","44.2446043165467600","HOMEM"
"250640005000002","1","158","106","264","59.848484848484850","40.1515151515151500","HOMEM"
"250640005000003","1","130","91","221","58.823529411764700","41.1764705882353000","HOMEM"
"250640005000004","1","111","56","167","66.467065868263480","33.5329341317365250","HOMEM"
"250640005000005","1","268","139","407","65.847665847665850","34.1523341523341560","HOMEM"
"250640005000006","1","157","50","207","75.845410628019320","24.1545893719806770","HOMEM"
"250640005000007","8","159","28","187","85.026737967914440","14.9732620320855610","HOMEM"
"250640005000008","8","182","63","245","74.285714285714290","25.7142857142857150","HOMEM"
"250640005000009","8","120","36","156","76.923076923076920","23.0769230769230770","HOMEM"
"250640005000010","8","107","55","162","66.049382716049380","33.9506172839506200","HOMEM"
"250640005000011","8","112","29","141","79.432624113475170","20.5673758865248200","HOMEM"
"250640005000012","8","168","37","205","81.951219512195120","18.0487804878048760","HOMEM"
"250640005000013","5","51","29","80","63.750000000000000","36.2500000000000000","HOMEM"
"250640005000014","8","86","40","126","68.253968253968250","31.7460317460317470","HOMEM"
"250640005000015","5","277","147","424","65.330188679245280","34.6698113207547200","HOMEM"
"250640005000016","5","56","29","85","65.882352941176460","34.1176470588235300","HOMEM"
"250640005000017","4","127","49","176","72.159090909090900","27.8409090909090900","HOMEM"
"250640005000018","1","95","56","151","62.913907284768214","37.0860927152317860","HOMEM"
"250640005000019","8","0","0","0",NULL,NULL,NULL
"250640005000020","8","53","14","67","79.104477611940300","20.8955223880597030","HOMEM"
"250640005000021","8","0","0","0",NULL,NULL,NULL
"250640005000022","8","85","28","113","75.221238938053090","24.7787610619469020","HOMEM"
"250650905000001","1","222","127","349","63.610315186246420","36.3896848137535800","HOMEM"
"250650905000002","1","139","165","304","45.723684210526315","54.2763157894736850","MULHER"
"250650905000003","8","51","109","160","31.875000000000000","68.1250000000000000","MULHER"
"250650905000004","8","94","35","129","72.868217054263570","27.1317829457364330","HOMEM"
"250660805000001","1","152","78","230","66.086956521739130","33.9130434782608700","HOMEM"
"250660805000002","1","164","141","305","53.770491803278690","46.2295081967213100","HOMEM"
"250660805000003","1","184","102","286","64.335664335664330","35.6643356643356700","HOMEM"
"250660805000004","1","74","184","258","28.682170542635660","71.3178294573643400","MULHER"
"250660805000005","8","154","19","173","89.017341040462430","10.9826589595375720","HOMEM"
"250660805000006","8","43","44","87","49.425287356321840","50.5747126436781600","MULHER"
"250660805000007","8","57","42","99","57.575757575757580","42.4242424242424200","HOMEM"
"250660805000008","5","34","27","61","55.737704918032790","44.2622950819672100","HOMEM"
"250660805000009","8","60","52","112","53.571428571428570","46.4285714285714300","HOMEM"
"250660810000001","1","24","43","67","35.820895522388060","64.1791044776119400","MULHER"
"250660810000002","8","49","35","84","58.333333333333336","41.6666666666666640","HOMEM"
"250670705000001","1","196","224","420","46.666666666666664","53.3333333333333360","MULHER"
"250670705000002","1","102","184","286","35.664335664335670","64.3356643356643300","MULHER"
"250670705000003","1","322","118","440","73.181818181818190","26.8181818181818170","HOMEM"
"250670705000004","8","102","36","138","73.913043478260870","26.0869565217391300","HOMEM"
"250670705000005","8","123","62","185","66.486486486486480","33.5135135135135160","HOMEM"
"250670705000006","8","120","32","152","78.947368421052630","21.0526315789473700","HOMEM"
"250670705000007","8","29","66","95","30.526315789473685","69.4736842105263200","MULHER"
"250670705000008","8","53","31","84","63.095238095238095","36.9047619047619050","HOMEM"
"250670705000009","8","21","21","42","50.000000000000000","50.0000000000000000","IGUAL"
"250670705000010","8","77","29","106","72.641509433962270","27.3584905660377370","HOMEM"
"250670705000011","8","14","48","62","22.580645161290324","77.4193548387096800","MULHER"
"250670705000012","5","39","50","89","43.820224719101130","56.1797752808988700","MULHER"
"250670715000001","1","142","122","264","53.787878787878790","46.2121212121212100","HOMEM"
"250670715000002","8","48","6","54","88.888888888888890","11.1111111111111100","HOMEM"
"250670715000003","8","102","27","129","79.069767441860460","20.9302325581395370","HOMEM"
"250670715000004","8","73","21","94","77.659574468085110","22.3404255319148920","HOMEM"
"250670715000005","8","140","15","155","90.322580645161300","9.6774193548387100","HOMEM"
"250670715000006","8","37","19","56","66.071428571428570","33.9285714285714300","HOMEM"
"250670715000007","8","39","16","55","70.909090909090900","29.0909090909090900","HOMEM"
"250680605000001","1","172","133","305","56.393442622950820","43.6065573770491800","HOMEM"
"250680605000002","1","157","120","277","56.678700361010830","43.3212996389891700","HOMEM"
"250680605000003","1","105","53","158","66.455696202531640","33.5443037974683500","HOMEM"
"250680605000004","1","71","295","366","19.398907103825138","80.6010928961748600","MULHER"
"250680605000005","1","170","109","279","60.931899641577060","39.0681003584229400","HOMEM"
"250680605000006","1","210","100","310","67.741935483870960","32.2580645161290300","HOMEM"
"250680605000007","1","141","138","279","50.537634408602150","49.4623655913978500","HOMEM"
"250680605000008","1","151","114","265","56.981132075471700","43.0188679245283000","HOMEM"
"250680605000009","1","193","132","325","59.384615384615390","40.6153846153846100","HOMEM"
"250680605000010","1","139","269","408","34.068627450980394","65.9313725490196100","MULHER"
"250680605000011","8","134","39","173","77.456647398843930","22.5433526011560700","HOMEM"
"250680605000012","8","107","21","128","83.593750000000000","16.4062500000000000","HOMEM"
"250680605000013","8","267","51","318","83.962264150943400","16.0377358490566020","HOMEM"
"250680605000014","8","227","73","300","75.666666666666670","24.3333333333333320","HOMEM"
"250680605000015","1","148","118","266","55.639097744360900","44.3609022556391000","HOMEM"
"250680605000016","5","107","27","134","79.850746268656720","20.1492537313432830","HOMEM"
"250680607000001","1","131","64","195","67.179487179487180","32.8205128205128200","HOMEM"
"250680607000002","5","120","83","203","59.113300492610840","40.8866995073891600","HOMEM"
"250680607000003","8","103","112","215","47.906976744186046","52.0930232558139540","MULHER"
"250680607000004","8","245","81","326","75.153374233128830","24.8466257668711670","HOMEM"
"250690505000001","1","115","175","290","39.655172413793100","60.3448275862069000","MULHER"
"250690505000002","1","147","68","215","68.372093023255810","31.6279069767441850","HOMEM"
"250690505000003","1","146","80","226","64.601769911504420","35.3982300884955700","HOMEM"
"250690505000004","1","174","103","277","62.815884476534290","37.1841155234657100","HOMEM"
"250690505000005","1","93","205","298","31.208053691275170","68.7919463087248300","MULHER"
"250690505000006","1","107","83","190","56.315789473684210","43.6842105263157900","HOMEM"
"250690505000007","1","114","117","231","49.350649350649350","50.6493506493506500","MULHER"
"250690505000008","1","232","114","346","67.052023121387280","32.9479768786127140","HOMEM"
"250690505000009","1","132","79","211","62.559241706161140","37.4407582938388600","HOMEM"
"250690505000010","1","159","122","281","56.583629893238430","43.4163701067615700","HOMEM"
"250690505000011","1","141","101","242","58.264462809917354","41.7355371900826460","HOMEM"
"250690505000012","1","162","70","232","69.827586206896560","30.1724137931034500","HOMEM"
"250690505000013","1","142","192","334","42.514970059880240","57.4850299401197600","MULHER"
"250690505000014","1","121","135","256","47.265625000000000","52.7343750000000000","MULHER"
"250690505000015","1","115","129","244","47.131147540983605","52.8688524590163950","MULHER"
"250690505000016","1","105","90","195","53.846153846153850","46.1538461538461500","HOMEM"
"250690505000017","1","180","134","314","57.324840764331210","42.6751592356687900","HOMEM"
"250690505000018","1","145","129","274","52.919708029197080","47.0802919708029200","HOMEM"
"250690505000019","1","126","94","220","57.272727272727270","42.7272727272727300","HOMEM"
"250690505000020","1","173","91","264","65.530303030303030","34.4696969696969700","HOMEM"
"250690505000021","1","217","161","378","57.407407407407405","42.5925925925925950","HOMEM"
"250690505000022","8","192","60","252","76.190476190476190","23.8095238095238100","HOMEM"
"250690505000023","5","132","96","228","57.894736842105260","42.1052631578947400","HOMEM"
"250690505000024","8","52","51","103","50.485436893203880","49.5145631067961200","HOMEM"
"250690505000025","8","167","71","238","70.168067226890760","29.8319327731092440","HOMEM"
"250690505000026","1","137","65","202","67.821782178217820","32.1782178217821800","HOMEM"
"250690510000001","1","121","186","307","39.413680781758956","60.5863192182410440","MULHER"
"250690510000002","8","57","21","78","73.076923076923080","26.9230769230769230","HOMEM"
"250690510000003","5","49","27","76","64.473684210526320","35.5263157894736850","HOMEM"
"250690510000004","8","39","13","52","75.000000000000000","25.0000000000000000","HOMEM"
"250690515000001","1","52","31","83","62.650602409638550","37.3493975903614500","HOMEM"
"250690515000002","8","161","39","200","80.500000000000000","19.5000000000000000","HOMEM"
"250690515000003","8","78","50","128","60.937500000000000","39.0625000000000000","HOMEM"
"250700205000001","1","154","136","290","53.103448275862070","46.8965517241379300","HOMEM"
"250700205000002","1","263","110","373","70.509383378016080","29.4906166219839140","HOMEM"
"250700205000003","1","185","103","288","64.236111111111110","35.7638888888888860","HOMEM"
"250700205000004","1","182","149","331","54.984894259818730","45.0151057401812700","HOMEM"
"250700205000005","1","173","115","288","60.069444444444440","39.9305555555555600","HOMEM"
"250700205000006","1","285","116","401","71.072319201995010","28.9276807980049900","HOMEM"
"250700205000007","1","297","102","399","74.436090225563920","25.5639097744360900","HOMEM"
"250700205000008","1","181","160","341","53.079178885630500","46.9208211143695000","HOMEM"
"250700205000009","1","159","89","248","64.112903225806450","35.8870967741935500","HOMEM"
"250700205000010","1","155","141","296","52.364864864864860","47.6351351351351400","HOMEM"
"250700205000011","1","176","100","276","63.768115942028984","36.2318840579710160","HOMEM"
"250700205000012","1","179","176","355","50.422535211267610","49.5774647887323900","HOMEM"
"250700205000013","1","202","90","292","69.178082191780820","30.8219178082191800","HOMEM"
"250700205000014","1","173","105","278","62.230215827338130","37.7697841726618700","HOMEM"
"250700205000015","8","79","16","95","83.157894736842110","16.8421052631578940","HOMEM"
"250700205000016","8","120","18","138","86.956521739130440","13.0434782608695650","HOMEM"
"250700205000017","8","87","12","99","87.878787878787880","12.1212121212121210","HOMEM"
"250700205000018","8","107","13","120","89.166666666666670","10.8333333333333340","HOMEM"
"250700205000019","8","49","66","115","42.608695652173914","57.3913043478260860","MULHER"
"250700205000020","8","94","21","115","81.739130434782610","18.2608695652173900","HOMEM"
"250700205000021","8","99","17","116","85.344827586206890","14.6551724137931030","HOMEM"
"250700205000022","8","100","19","119","84.033613445378150","15.9663865546218490","HOMEM"
"250700205000023","8","54","9","63","85.714285714285710","14.2857142857142860","HOMEM"
"250700205000024","8","168","35","203","82.758620689655170","17.2413793103448300","HOMEM"
"250700205000025","8","36","2","38","94.736842105263160","5.2631578947368425","HOMEM"
"250700205000026","8","146","13","159","91.823899371069190","8.1761006289308180","HOMEM"
"250700205000027","1","209","93","302","69.205298013245030","30.7947019867549660","HOMEM"
"250700205000028","1","210","76","286","73.426573426573430","26.5734265734265730","HOMEM"
"250710105000001","1","164","83","247","66.396761133603230","33.6032388663967600","HOMEM"
"250710105000002","1","189","108","297","63.636363636363630","36.3636363636363700","HOMEM"
"250710105000003","1","185","91","276","67.028985507246380","32.9710144927536250","HOMEM"
"250710105000004","1","173","107","280","61.785714285714285","38.2142857142857150","HOMEM"
"250710105000005","1","156","98","254","61.417322834645670","38.5826771653543300","HOMEM"
"250710105000006","1","219","98","317","69.085173501577290","30.9148264984227130","HOMEM"
"250710105000007","1","260","143","403","64.516129032258060","35.4838709677419360","HOMEM"
"250710105000008","1","290","87","377","76.923076923076920","23.0769230769230770","HOMEM"
"250710105000009","1","133","79","212","62.735849056603776","37.2641509433962240","HOMEM"
"250710105000010","8","93","32","125","74.400000000000000","25.6000000000000000","HOMEM"
"250710105000011","8","119","38","157","75.796178343949040","24.2038216560509550","HOMEM"
"250710105000012","8","209","73","282","74.113475177304960","25.8865248226950370","HOMEM"
"250710105000013","8","92","35","127","72.440944881889760","27.5590551181102370","HOMEM"
"250710105000014","8","47","9","56","83.928571428571430","16.0714285714285730","HOMEM"
"250710105000015","8","115","34","149","77.181208053691280","22.8187919463087250","HOMEM"
"250710105000016","8","85","18","103","82.524271844660190","17.4757281553398050","HOMEM"
"250710105000017","8","98","21","119","82.352941176470600","17.6470588235294130","HOMEM"
"250710105000018","8","139","17","156","89.102564102564100","10.8974358974358980","HOMEM"
"250710105000019","8","86","27","113","76.106194690265480","23.8938053097345140","HOMEM"
"250710105000020","8","126","29","155","81.290322580645170","18.7096774193548400","HOMEM"
"250710105000021","1","181","130","311","58.199356913183280","41.8006430868167200","HOMEM"
"250710105000022","1","127","87","214","59.345794392523366","40.6542056074766340","HOMEM"
"250710105000023","8","52","9","61","85.245901639344270","14.7540983606557370","HOMEM"
"250720005000001","1","51","54","105","48.571428571428570","51.4285714285714300","MULHER"
"250720005000002","1","259","164","423","61.229314420803780","38.7706855791962200","HOMEM"
"250720005000003","1","237","127","364","65.109890109890120","34.8901098901098900","HOMEM"
"250720005000004","1","124","91","215","57.674418604651166","42.3255813953488340","HOMEM"
"250720005000005","1","223","96","319","69.905956112852660","30.0940438871473360","HOMEM"
"250720005000006","8","222","55","277","80.144404332129970","19.8555956678700380","HOMEM"
"250720005000007","8","78","14","92","84.782608695652170","15.2173913043478260","HOMEM"
"250720005000008","5","58","20","78","74.358974358974360","25.6410256410256420","HOMEM"
"250720005000009","8","197","54","251","78.486055776892430","21.5139442231075700","HOMEM"
"250720005000010","8","120","103","223","53.811659192825110","46.1883408071748900","HOMEM"
"250720005000011","8","41","22","63","65.079365079365080","34.9206349206349200","HOMEM"
"250720005000012","5","46","23","69","66.666666666666670","33.3333333333333360","HOMEM"
"250720005000013","1","146","94","240","60.833333333333336","39.1666666666666640","HOMEM"
"250720005000014","5","89","27","116","76.724137931034480","23.2758620689655160","HOMEM"
"250730905000001","1","172","107","279","61.648745519713260","38.3512544802867400","HOMEM"
"250730905000002","1","74","90","164","45.121951219512200","54.8780487804878000","MULHER"
"250730905000003","1","217","96","313","69.329073482428110","30.6709265175718850","HOMEM"
"250730905000004","1","133","79","212","62.735849056603776","37.2641509433962240","HOMEM"
"250730905000005","1","140","67","207","67.632850241545900","32.3671497584541040","HOMEM"
"250730905000006","8","99","35","134","73.880597014925370","26.1194029850746250","HOMEM"
"250730905000007","8","97","35","132","73.484848484848480","26.5151515151515160","HOMEM"
"250730905000008","8","29","11","40","72.500000000000000","27.5000000000000000","HOMEM"
"250730905000009","8","69","19","88","78.409090909090900","21.5909090909090900","HOMEM"
"250730905000010","8","93","20","113","82.300884955752210","17.6991150442477870","HOMEM"
"250730905000011","8","65","9","74","87.837837837837840","12.1621621621621610","HOMEM"
"250730905000012","8","68","36","104","65.384615384615390","34.6153846153846100","HOMEM"
"250730905000013","1","123","85","208","59.134615384615390","40.8653846153846100","HOMEM"
"250730905000014","1","101","65","166","60.843373493975900","39.1566265060241000","HOMEM"
"250730905000015","1","87","69","156","55.769230769230770","44.2307692307692300","HOMEM"
"250730905000016","1","136","90","226","60.176991150442475","39.8230088495575250","HOMEM"
"250730905000017","1","104","84","188","55.319148936170215","44.6808510638297850","HOMEM"
"250730905000018","8","98","26","124","79.032258064516130","20.9677419354838720","HOMEM"
"250730905000019","8","79","35","114","69.298245614035080","30.7017543859649100","HOMEM"
"250730905000020","8","143","81","224","63.839285714285715","36.1607142857142850","HOMEM"
"250730910000001","1","233","82","315","73.968253968253960","26.0317460317460300","HOMEM"
"250730910000002","8","58","26","84","69.047619047619050","30.9523809523809530","HOMEM"
"250730910000003","8","133","63","196","67.857142857142860","32.1428571428571460","HOMEM"
"250730910000004","8","63","32","95","66.315789473684200","33.6842105263157900","HOMEM"
"250730910000005","8","85","14","99","85.858585858585850","14.1414141414141420","HOMEM"
"250740805000001","1","142","69","211","67.298578199052130","32.7014218009478700","HOMEM"
"250740805000002","1","94","63","157","59.872611464968150","40.1273885350318500","HOMEM"
"250740805000003","1","168","73","241","69.709543568464720","30.2904564315352700","HOMEM"
"250740805000004","8","161","42","203","79.310344827586200","20.6896551724137940","HOMEM"
"250740805000005","8","97","27","124","78.225806451612900","21.7741935483870960","HOMEM"
"250740805000006","8","139","14","153","90.849673202614380","9.1503267973856200","HOMEM"
"250740805000007","8","156","37","193","80.829015544041450","19.1709844559585500","HOMEM"
"250740805000008","5","68","14","82","82.926829268292680","17.0731707317073180","HOMEM"
"250740805000009","1","180","91","271","66.420664206642070","33.5793357933579340","HOMEM"
"250740805000010","1","122","88","210","58.095238095238095","41.9047619047619050","HOMEM"
"250740805000011","1","186","76","262","70.992366412213740","29.0076335877862600","HOMEM"
"250750705000001","1","39","57","96","40.625000000000000","59.3750000000000000","MULHER"
"250750705000002","1","86","198","284","30.281690140845072","69.7183098591549300","MULHER"
"250750705000003","1","84","103","187","44.919786096256686","55.0802139037433140","MULHER"
"250750705000004","1","53","33","86","61.627906976744185","38.3720930232558150","HOMEM"
"250750705000005","1","177","147","324","54.629629629629626","45.3703703703703740","HOMEM"
"250750705000006","1","125","118","243","51.440329218106996","48.5596707818930040","HOMEM"
"250750705000007","1","144","162","306","47.058823529411770","52.9411764705882300","MULHER"
"250750705000008","1","174","112","286","60.839160839160840","39.1608391608391600","HOMEM"
"250750705000009","1","80","54","134","59.701492537313435","40.2985074626865650","HOMEM"
"250750705000010","1","145","99","244","59.426229508196720","40.5737704918032800","HOMEM"
"250750705000011","1","233","126","359","64.902506963788300","35.0974930362117000","HOMEM"
"250750705000012","1","132","87","219","60.273972602739725","39.7260273972602750","HOMEM"
"250750705000013","1","109","216","325","33.538461538461540","66.4615384615384700","MULHER"
"250750705000014","1","151","119","270","55.925925925925924","44.0740740740740760","HOMEM"
"250750705000015","1","127","45","172","73.837209302325580","26.1627906976744170","HOMEM"
"250750705000016","1","137","239","376","36.436170212765960","63.5638297872340400","MULHER"
"250750705000018","1","13","16","29","44.827586206896555","55.1724137931034450","MULHER"
"250750705000019","1","115","102","217","52.995391705069125","47.0046082949308750","HOMEM"
"250750705000020","1","120","137","257","46.692607003891050","53.3073929961089500","MULHER"
"250750705000021","1","171","160","331","51.661631419939575","48.3383685800604250","HOMEM"
"250750705000022","1","146","173","319","45.768025078369910","54.2319749216300900","MULHER"
"250750705000023","1","143","119","262","54.580152671755730","45.4198473282442700","HOMEM"
"250750705000024","1","84","107","191","43.979057591623040","56.0209424083769600","MULHER"
"250750705000025","1","107","170","277","38.628158844765345","61.3718411552346550","MULHER"
"250750705000026","1","85","208","293","29.010238907849830","70.9897610921501800","MULHER"
"250750705000027","1","152","155","307","49.511400651465800","50.4885993485342000","MULHER"
"250750705000028","1","152","136","288","52.777777777777780","47.2222222222222200","HOMEM"
"250750705000029","1","78","177","255","30.588235294117650","69.4117647058823500","MULHER"
"250750705000030","1","281","272","553","50.813743218806510","49.1862567811934900","HOMEM"
"250750705000031","1","87","66","153","56.862745098039210","43.1372549019607900","HOMEM"
"250750705000032","1","100","71","171","58.479532163742690","41.5204678362573100","HOMEM"
"250750705000033","1","156","119","275","56.727272727272730","43.2727272727272700","HOMEM"
"250750705000034","1","174","172","346","50.289017341040460","49.7109826589595400","HOMEM"
"250750705000035","1","78","83","161","48.447204968944100","51.5527950310559000","MULHER"
"250750705000036","1","142","121","263","53.992395437262360","46.0076045627376400","HOMEM"
"250750705000037","1","67","55","122","54.918032786885250","45.0819672131147500","HOMEM"
"250750705000038","1","149","163","312","47.756410256410255","52.2435897435897450","MULHER"
"250750705000039","1","153","164","317","48.264984227129340","51.7350157728706600","MULHER"
"250750705000040","1","129","88","217","59.447004608294930","40.5529953917050700","HOMEM"
"250750705000041","1","172","161","333","51.651651651651655","48.3483483483483450","HOMEM"
"250750705000042","1","129","137","266","48.496240601503760","51.5037593984962400","MULHER"
"250750705000043","1","95","122","217","43.778801843317970","56.2211981566820300","MULHER"
"250750705000044","1","93","120","213","43.661971830985910","56.3380281690140900","MULHER"
"250750705000045","1","123","133","256","48.046875000000000","51.9531250000000000","MULHER"
"250750705000046","1","103","96","199","51.758793969849240","48.2412060301507600","HOMEM"
"250750705000047","1","138","167","305","45.245901639344260","54.7540983606557400","MULHER"
"250750705000048","1","153","107","260","58.846153846153850","41.1538461538461500","HOMEM"
"250750705000049","1","124","63","187","66.310160427807490","33.6898395721925100","HOMEM"
"250750705000050","1","28","54","82","34.146341463414636","65.8536585365853700","MULHER"
"250750705000051","1","207","194","401","51.620947630922690","48.3790523690773100","HOMEM"
"250750705000052","1","151","115","266","56.766917293233085","43.2330827067669150","HOMEM"
"250750705000053","1","171","111","282","60.638297872340424","39.3617021276595760","HOMEM"
"250750705000054","1","86","103","189","45.502645502645500","54.4973544973545000","MULHER"
"250750705000055","1","134","127","261","51.340996168582380","48.6590038314176200","HOMEM"
"250750705000056","1","119","97","216","55.092592592592595","44.9074074074074050","HOMEM"
"250750705000057","1","129","173","302","42.715231788079470","57.2847682119205300","MULHER"
"250750705000058","1","104","78","182","57.142857142857146","42.8571428571428540","HOMEM"
"250750705000059","1","127","118","245","51.836734693877550","48.1632653061224500","HOMEM"
"250750705000060","1","183","150","333","54.954954954954960","45.0450450450450400","HOMEM"
"250750705000061","1","170","146","316","53.797468354430380","46.2025316455696200","HOMEM"
"250750705000062","1","197","112","309","63.754045307443360","36.2459546925566400","HOMEM"
"250750705000063","1","229","121","350","65.428571428571430","34.5714285714285700","HOMEM"
"250750705000064","1","125","65","190","65.789473684210520","34.2105263157894700","HOMEM"
"250750705000065","1","154","100","254","60.629921259842520","39.3700787401574800","HOMEM"
"250750705000066","1","172","97","269","63.940520446096656","36.0594795539033440","HOMEM"
"250750705000067","1","84","15","99","84.848484848484840","15.1515151515151520","HOMEM"
"250750705000068","1","197","90","287","68.641114982578400","31.3588850174216030","HOMEM"
"250750705000069","1","198","118","316","62.658227848101270","37.3417721518987300","HOMEM"
"250750705000070","1","112","49","161","69.565217391304340","30.4347826086956520","HOMEM"
"250750705000071","1","182","137","319","57.053291536050150","42.9467084639498500","HOMEM"
"250750705000072","1","130","162","292","44.520547945205480","55.4794520547945200","MULHER"
"250750705000073","1","85","88","173","49.132947976878610","50.8670520231213900","MULHER"
"250750705000074","1","103","104","207","49.758454106280190","50.2415458937198100","MULHER"
"250750705000075","1","67","69","136","49.264705882352940","50.7352941176470600","MULHER"
"250750705000076","1","217","82","299","72.575250836120400","27.4247491638796000","HOMEM"
"250750705000077","1","163","182","345","47.246376811594200","52.7536231884058000","MULHER"
"250750705000078","1","200","171","371","53.908355795148246","46.0916442048517540","HOMEM"
"250750705000079","1","243","131","374","64.973262032085560","35.0267379679144360","HOMEM"
"250750705000080","1","176","93","269","65.427509293680300","34.5724907063197050","HOMEM"
"250750705000081","1","146","102","248","58.870967741935480","41.1290322580645200","HOMEM"
"250750705000082","1","114","88","202","56.435643564356430","43.5643564356435700","HOMEM"
"250750705000083","1","221","161","382","57.853403141361255","42.1465968586387450","HOMEM"
"250750705000084","1","194","92","286","67.832167832167830","32.1678321678321700","HOMEM"
"250750705000085","1","241","104","345","69.855072463768110","30.1449275362318830","HOMEM"
"250750705000086","1","155","102","257","60.311284046692606","39.6887159533073940","HOMEM"
"250750705000087","1","227","116","343","66.180758017492700","33.8192419825072860","HOMEM"
"250750705000088","1","182","123","305","59.672131147540980","40.3278688524590200","HOMEM"
"250750705000089","1","129","92","221","58.371040723981900","41.6289592760181000","HOMEM"
"250750705000090","1","196","84","280","70.000000000000000","30.0000000000000000","HOMEM"
"250750705000091","1","70","82","152","46.052631578947370","53.9473684210526300","MULHER"
"250750705000092","1","109","72","181","60.220994475138120","39.7790055248618800","HOMEM"
"250750705000093","1","153","94","247","61.943319838056680","38.0566801619433200","HOMEM"
"250750705000094","1","64","89","153","41.830065359477125","58.1699346405228750","MULHER"
"250750705000095","1","205","130","335","61.194029850746270","38.8059701492537300","HOMEM"
"250750705000096","1","201","96","297","67.676767676767680","32.3232323232323250","HOMEM"
"250750705000097","1","297","101","398","74.623115577889450","25.3768844221105530","HOMEM"
"250750705000098","1","230","134","364","63.186813186813190","36.8131868131868100","HOMEM"
"250750705000099","1","181","138","319","56.739811912225704","43.2601880877742960","HOMEM"
"250750705000100","1","88","151","239","36.820083682008370","63.1799163179916300","MULHER"
"250750705000101","1","137","92","229","59.825327510917030","40.1746724890829700","HOMEM"
"250750705000102","1","123","172","295","41.694915254237290","58.3050847457627100","MULHER"
"250750705000103","1","83","60","143","58.041958041958040","41.9580419580419600","HOMEM"
"250750705000104","1","155","124","279","55.555555555555560","44.4444444444444400","HOMEM"
"250750705000105","1","187","85","272","68.750000000000000","31.2500000000000000","HOMEM"
"250750705000106","1","194","99","293","66.211604095563150","33.7883959044368600","HOMEM"
"250750705000107","1","31","70","101","30.693069306930692","69.3069306930693000","MULHER"
"250750705000108","1","65","149","214","30.373831775700936","69.6261682242990600","MULHER"
"250750705000109","1","57","53","110","51.818181818181820","48.1818181818181800","HOMEM"
"250750705000110","1","121","101","222","54.504504504504500","45.4954954954955000","HOMEM"
"250750705000111","1","91","232","323","28.173374613003094","71.8266253869969100","MULHER"
"250750705000112","1","124","95","219","56.621004566210050","43.3789954337899500","HOMEM"
"250750705000113","1","89","84","173","51.445086705202314","48.5549132947976860","HOMEM"
"250750705000114","1","108","111","219","49.315068493150680","50.6849315068493200","MULHER"
"250750705000115","1","66","94","160","41.250000000000000","58.7500000000000000","MULHER"
"250750705000116","1","69","32","101","68.316831683168320","31.6831683168316830","HOMEM"
"250750705000117","1","102","91","193","52.849740932642490","47.1502590673575100","HOMEM"
"250750705000118","1","68","103","171","39.766081871345030","60.2339181286549700","MULHER"
"250750705000119","1","160","123","283","56.537102473498230","43.4628975265017700","HOMEM"
"250750705000120","1","151","165","316","47.784810126582280","52.2151898734177200","MULHER"
"250750705000121","1","93","80","173","53.757225433526010","46.2427745664739900","HOMEM"
"250750705000122","1","193","87","280","68.928571428571430","31.0714285714285730","HOMEM"
"250750705000123","1","146","135","281","51.957295373665480","48.0427046263345200","HOMEM"
"250750705000124","1","138","71","209","66.028708133971290","33.9712918660287100","HOMEM"
"250750705000125","1","149","110","259","57.528957528957530","42.4710424710424700","HOMEM"
"250750705000126","1","115","87","202","56.930693069306930","43.0693069306930700","HOMEM"
"250750705000127","1","69","84","153","45.098039215686280","54.9019607843137200","MULHER"
"250750705000128","1","109","47","156","69.871794871794880","30.1282051282051280","HOMEM"
"250750705000129","1","192","150","342","56.140350877192980","43.8596491228070200","HOMEM"
"250750705000130","1","91","119","210","43.333333333333336","56.6666666666666640","MULHER"
"250750705000131","1","113","108","221","51.131221719457020","48.8687782805429800","HOMEM"
"250750705000132","1","133","234","367","36.239782016348780","63.7602179836512200","MULHER"
"250750705000133","1","150","130","280","53.571428571428570","46.4285714285714300","HOMEM"
"250750705000134","1","88","104","192","45.833333333333336","54.1666666666666640","MULHER"
"250750705000135","1","88","88","176","50.000000000000000","50.0000000000000000","IGUAL"
"250750705000136","1","83","64","147","56.462585034013610","43.5374149659863900","HOMEM"
"250750705000137","1","75","82","157","47.770700636942680","52.2292993630573200","MULHER"
"250750705000138","1","157","149","306","51.307189542483660","48.6928104575163400","HOMEM"
"250750705000139","1","49","54","103","47.572815533980580","52.4271844660194200","MULHER"
"250750705000140","1","39","52","91","42.857142857142854","57.1428571428571460","MULHER"
"250750705000141","1","82","119","201","40.796019900497510","59.2039800995024900","MULHER"
"250750705000142","1","17","25","42","40.476190476190474","59.5238095238095260","MULHER"
"250750705000143","1","79","83","162","48.765432098765430","51.2345679012345700","MULHER"
"250750705000144","1","100","65","165","60.606060606060610","39.3939393939393900","HOMEM"
"250750705000145","1","44","48","92","47.826086956521740","52.1739130434782600","MULHER"
"250750705000146","1","66","83","149","44.295302013422820","55.7046979865771800","MULHER"
"250750705000147","1","70","57","127","55.118110236220474","44.8818897637795260","HOMEM"
"250750705000148","1","97","58","155","62.580645161290320","37.4193548387096800","HOMEM"
"250750705000149","1","90","97","187","48.128342245989300","51.8716577540107000","MULHER"
"250750705000150","1","145","146","291","49.828178694158076","50.1718213058419240","MULHER"
"250750705000151","1","121","117","238","50.840336134453780","49.1596638655462200","HOMEM"
"250750705000152","1","180","136","316","56.962025316455694","43.0379746835443060","HOMEM"
"250750705000153","1","120","75","195","61.538461538461540","38.4615384615384600","HOMEM"
"250750705000154","1","120","152","272","44.117647058823530","55.8823529411764700","MULHER"
"250750705000155","1","133","73","206","64.563106796116500","35.4368932038834900","HOMEM"
"250750705000156","1","182","69","251","72.509960159362550","27.4900398406374500","HOMEM"
"250750705000157","1","80","89","169","47.337278106508876","52.6627218934911240","MULHER"
"250750705000158","1","77","62","139","55.395683453237410","44.6043165467625900","HOMEM"
"250750705000159","1","129","75","204","63.235294117647060","36.7647058823529400","HOMEM"
"250750705000160","1","33","22","55","60.000000000000000","40.0000000000000000","HOMEM"
"250750705000161","1","130","106","236","55.084745762711860","44.9152542372881400","HOMEM"
"250750705000162","1","78","42","120","65.000000000000000","35.0000000000000000","HOMEM"
"250750705000163","1","127","140","267","47.565543071161050","52.4344569288389500","MULHER"
"250750705000164","1","122","94","216","56.481481481481480","43.5185185185185200","HOMEM"
"250750705000165","1","133","101","234","56.837606837606835","43.1623931623931650","HOMEM"
"250750705000166","1","70","36","106","66.037735849056600","33.9622641509434000","HOMEM"
"250750705000167","1","166","123","289","57.439446366782010","42.5605536332179900","HOMEM"
"250750705000168","1","181","125","306","59.150326797385624","40.8496732026143760","HOMEM"
"250750705000169","1","150","138","288","52.083333333333336","47.9166666666666640","HOMEM"
"250750705000170","1","45","44","89","50.561797752808985","49.4382022471910150","HOMEM"
"250750705000171","1","165","100","265","62.264150943396224","37.7358490566037760","HOMEM"
"250750705000172","1","129","109","238","54.201680672268910","45.7983193277310900","HOMEM"
"250750705000173","1","227","79","306","74.183006535947710","25.8169934640522900","HOMEM"
"250750705000174","1","203","86","289","70.242214532871970","29.7577854671280270","HOMEM"
"250750705000175","1","185","83","268","69.029850746268650","30.9701492537313430","HOMEM"
"250750705000176","1","181","82","263","68.821292775665400","31.1787072243346000","HOMEM"
"250750705000177","1","151","228","379","39.841688654353560","60.1583113456464400","MULHER"
"250750705000178","1","86","109","195","44.102564102564100","55.8974358974359000","MULHER"
"250750705000179","1","98","160","258","37.984496124031010","62.0155038759689900","MULHER"
"250750705000180","1","138","122","260","53.076923076923080","46.9230769230769200","HOMEM"
"250750705000181","1","138","126","264","52.272727272727270","47.7272727272727300","HOMEM"
"250750705000182","1","189","123","312","60.576923076923080","39.4230769230769200","HOMEM"
"250750705000183","1","145","101","246","58.943089430894310","41.0569105691056900","HOMEM"
"250750705000184","1","179","95","274","65.328467153284680","34.6715328467153300","HOMEM"
"250750705000185","1","308","133","441","69.841269841269830","30.1587301587301580","HOMEM"
"250750705000186","1","148","116","264","56.060606060606060","43.9393939393939400","HOMEM"
"250750705000187","1","159","94","253","62.845849802371540","37.1541501976284600","HOMEM"
"250750705000188","1","158","118","276","57.246376811594200","42.7536231884058000","HOMEM"
"250750705000189","1","145","120","265","54.716981132075475","45.2830188679245250","HOMEM"
"250750705000190","1","174","120","294","59.183673469387756","40.8163265306122440","HOMEM"
"250750705000191","1","31","90","121","25.619834710743802","74.3801652892562000","MULHER"
"250750705000192","1","179","115","294","60.884353741496600","39.1156462585034000","HOMEM"
"250750705000193","1","182","138","320","56.875000000000000","43.1250000000000000","HOMEM"
"250750705000194","1","176","56","232","75.862068965517240","24.1379310344827580","HOMEM"
"250750705000195","1","155","109","264","58.712121212121210","41.2878787878787900","HOMEM"
"250750705000196","1","89","60","149","59.731543624161080","40.2684563758389200","HOMEM"
"250750705000197","1","105","172","277","37.906137184115520","62.0938628158844800","MULHER"
"250750705000198","1","169","75","244","69.262295081967210","30.7377049180327870","HOMEM"
"250750705000199","1","182","51","233","78.111587982832620","21.8884120171673830","HOMEM"
"250750705000200","1","123","42","165","74.545454545454550","25.4545454545454530","HOMEM"
"250750705000201","1","70","93","163","42.944785276073620","57.0552147239263800","MULHER"
"250750705000202","1","280","152","432","64.814814814814810","35.1851851851851800","HOMEM"
"250750705000203","1","140","125","265","52.830188679245280","47.1698113207547200","HOMEM"
"250750705000204","1","101","71","172","58.720930232558140","41.2790697674418600","HOMEM"
"250750705000205","1","179","92","271","66.051660516605170","33.9483394833948300","HOMEM"
"250750705000206","1","237","123","360","65.833333333333330","34.1666666666666640","HOMEM"
"250750705000207","1","214","84","298","71.812080536912750","28.1879194630872480","HOMEM"
"250750705000208","1","68","40","108","62.962962962962960","37.0370370370370400","HOMEM"
"250750705000209","1","123","84","207","59.420289855072460","40.5797101449275400","HOMEM"
"250750705000210","1","143","73","216","66.203703703703710","33.7962962962963000","HOMEM"
"250750705000211","1","145","100","245","59.183673469387756","40.8163265306122440","HOMEM"
"250750705000212","1","150","124","274","54.744525547445260","45.2554744525547400","HOMEM"
"250750705000213","1","234","96","330","70.909090909090900","29.0909090909090900","HOMEM"
"250750705000214","1","108","75","183","59.016393442622950","40.9836065573770500","HOMEM"
"250750705000215","1","63","124","187","33.689839572192510","66.3101604278074900","MULHER"
"250750705000216","1","165","63","228","72.368421052631580","27.6315789473684200","HOMEM"
"250750705000217","1","155","93","248","62.500000000000000","37.5000000000000000","HOMEM"
"250750705000218","1","182","89","271","67.158671586715870","32.8413284132841300","HOMEM"
"250750705000219","1","150","107","257","58.365758754863810","41.6342412451361900","HOMEM"
"250750705000220","1","62","12","74","83.783783783783790","16.2162162162162180","HOMEM"
"250750705000221","1","97","75","172","56.395348837209305","43.6046511627906950","HOMEM"
"250750705000222","1","157","117","274","57.299270072992700","42.7007299270073000","HOMEM"
"250750705000223","1","144","148","292","49.315068493150680","50.6849315068493200","MULHER"
"250750705000224","1","157","99","256","61.328125000000000","38.6718750000000000","HOMEM"
"250750705000225","1","40","78","118","33.898305084745765","66.1016949152542400","MULHER"
"250750705000226","1","99","101","200","49.500000000000000","50.5000000000000000","MULHER"
"250750705000227","1","96","130","226","42.477876106194690","57.5221238938053100","MULHER"
"250750705000228","1","125","65","190","65.789473684210520","34.2105263157894700","HOMEM"
"250750705000229","1","48","52","100","48.000000000000000","52.0000000000000000","MULHER"
"250750705000230","1","189","214","403","46.898263027295286","53.1017369727047140","MULHER"
"250750705000231","1","69","147","216","31.944444444444443","68.0555555555555600","MULHER"
"250750705000232","1","117","178","295","39.661016949152540","60.3389830508474600","MULHER"
"250750705000233","1","149","155","304","49.013157894736840","50.9868421052631600","MULHER"
"250750705000234","1","149","227","376","39.627659574468080","60.3723404255319200","MULHER"
"250750705000235","1","92","117","209","44.019138755980860","55.9808612440191400","MULHER"
"250750705000236","1","200","127","327","61.162079510703364","38.8379204892966360","HOMEM"
"250750705000237","1","185","80","265","69.811320754716990","30.1886792452830200","HOMEM"
"250750705000238","1","165","113","278","59.352517985611510","40.6474820143884900","HOMEM"
"250750705000239","1","78","96","174","44.827586206896555","55.1724137931034450","MULHER"
"250750705000240","1","97","150","247","39.271255060728750","60.7287449392712500","MULHER"
"250750705000241","1","110","87","197","55.837563451776650","44.1624365482233500","HOMEM"
"250750705000242","1","121","145","266","45.488721804511280","54.5112781954887200","MULHER"
"250750705000243","1","59","121","180","32.777777777777780","67.2222222222222300","MULHER"
"250750705000244","1","128","121","249","51.405622489959840","48.5943775100401600","HOMEM"
"250750705000245","1","73","29","102","71.568627450980390","28.4313725490196060","HOMEM"
"250750705000246","1","109","108","217","50.230414746543780","49.7695852534562200","HOMEM"
"250750705000247","1","205","145","350","58.571428571428570","41.4285714285714300","HOMEM"
"250750705000248","1","119","113","232","51.293103448275865","48.7068965517241350","HOMEM"
"250750705000249","1","76","38","114","66.666666666666670","33.3333333333333360","HOMEM"
"250750705000250","1","171","116","287","59.581881533101050","40.4181184668989500","HOMEM"
"250750705000251","1","114","69","183","62.295081967213115","37.7049180327868850","HOMEM"
"250750705000252","1","102","82","184","55.434782608695650","44.5652173913043500","HOMEM"
"250750705000253","1","104","75","179","58.100558659217874","41.8994413407821260","HOMEM"
"250750705000254","1","63","84","147","42.857142857142854","57.1428571428571460","MULHER"
"250750705000255","1","94","79","173","54.335260115606935","45.6647398843930650","HOMEM"
"250750705000256","1","62","63","125","49.600000000000000","50.4000000000000000","MULHER"
"250750705000257","1","79","52","131","60.305343511450380","39.6946564885496200","HOMEM"
"250750705000258","1","65","25","90","72.222222222222230","27.7777777777777800","HOMEM"
"250750705000259","1","129","112","241","53.526970954356850","46.4730290456431500","HOMEM"
"250750705000260","1","178","182","360","49.444444444444440","50.5555555555555600","MULHER"
"250750705000261","1","148","176","324","45.679012345679010","54.3209876543209900","MULHER"
"250750705000262","1","14","41","55","25.454545454545453","74.5454545454545500","MULHER"
"250750705000263","1","39","22","61","63.934426229508200","36.0655737704918000","HOMEM"
"250750705000264","1","112","71","183","61.202185792349724","38.7978142076502760","HOMEM"
"250750705000265","1","116","58","174","66.666666666666670","33.3333333333333360","HOMEM"
"250750705000266","1","26","11","37","70.270270270270270","29.7297297297297300","HOMEM"
"250750705000267","1","53","59","112","47.321428571428570","52.6785714285714300","MULHER"
"250750705000268","1","83","96","179","46.368715083798880","53.6312849162011200","MULHER"
"250750705000269","1","119","129","248","47.983870967741936","52.0161290322580640","MULHER"
"250750705000270","1","58","51","109","53.211009174311926","46.7889908256880740","HOMEM"
"250750705000271","1","222","152","374","59.358288770053480","40.6417112299465200","HOMEM"
"250750705000272","1","155","122","277","55.956678700361010","44.0433212996389900","HOMEM"
"250750705000273","1","146","87","233","62.660944206008590","37.3390557939914100","HOMEM"
"250750705000274","1","84","113","197","42.639593908629440","57.3604060913705600","MULHER"
"250750705000275","1","131","98","229","57.205240174672490","42.7947598253275100","HOMEM"
"250750705000276","1","108","127","235","45.957446808510640","54.0425531914893600","MULHER"
"250750705000277","1","110","79","189","58.201058201058200","41.7989417989418000","HOMEM"
"250750705000278","1","28","23","51","54.901960784313720","45.0980392156862800","HOMEM"
"250750705000279","1","120","176","296","40.540540540540540","59.4594594594594600","MULHER"
"250750705000280","1","138","164","302","45.695364238410600","54.3046357615894000","MULHER"
"250750705000281","1","101","94","195","51.794871794871796","48.2051282051282040","HOMEM"
"250750705000282","1","79","102","181","43.646408839779006","56.3535911602209940","MULHER"
"250750705000283","1","51","82","133","38.345864661654130","61.6541353383458700","MULHER"
"250750705000284","1","102","136","238","42.857142857142854","57.1428571428571460","MULHER"
"250750705000285","1","174","137","311","55.948553054662376","44.0514469453376240","HOMEM"
"250750705000286","1","188","157","345","54.492753623188406","45.5072463768115940","HOMEM"
"250750705000287","1","215","168","383","56.135770234986940","43.8642297650130600","HOMEM"
"250750705000288","1","111","144","255","43.529411764705884","56.4705882352941160","MULHER"
"250750705000289","1","137","61","198","69.191919191919200","30.8080808080808100","HOMEM"
"250750705000290","1","154","132","286","53.846153846153850","46.1538461538461500","HOMEM"
"250750705000291","1","147","126","273","53.846153846153850","46.1538461538461500","HOMEM"
"250750705000292","1","89","72","161","55.279503105590060","44.7204968944099400","HOMEM"
"250750705000293","1","140","115","255","54.901960784313720","45.0980392156862800","HOMEM"
"250750705000294","1","122","78","200","61.000000000000000","39.0000000000000000","HOMEM"
"250750705000295","1","132","98","230","57.391304347826086","42.6086956521739140","HOMEM"
"250750705000296","1","156","78","234","66.666666666666670","33.3333333333333360","HOMEM"
"250750705000297","1","68","160","228","29.824561403508770","70.1754385964912300","MULHER"
"250750705000298","1","177","141","318","55.660377358490564","44.3396226415094360","HOMEM"
"250750705000299","1","196","143","339","57.817109144542776","42.1828908554572240","HOMEM"
"250750705000300","1","125","137","262","47.709923664122140","52.2900763358778600","MULHER"
"250750705000301","1","255","163","418","61.004784688995215","38.9952153110047850","HOMEM"
"250750705000302","1","132","154","286","46.153846153846150","53.8461538461538500","MULHER"
"250750705000303","1","114","110","224","50.892857142857146","49.1071428571428540","HOMEM"
"250750705000304","1","121","48","169","71.597633136094670","28.4023668639053250","HOMEM"
"250750705000305","1","169","104","273","61.904761904761905","38.0952380952380950","HOMEM"
"250750705000306","1","148","100","248","59.677419354838710","40.3225806451612900","HOMEM"
"250750705000307","1","74","19","93","79.569892473118270","20.4301075268817200","HOMEM"
"250750705000308","1","0","0","0",NULL,NULL,NULL
"250750705000309","1","73","56","129","56.589147286821710","43.4108527131782900","HOMEM"
"250750705000310","1","148","115","263","56.273764258555130","43.7262357414448700","HOMEM"
"250750705000311","1","159","141","300","53.000000000000000","47.0000000000000000","HOMEM"
"250750705000312","1","49","43","92","53.260869565217390","46.7391304347826100","HOMEM"
"250750705000313","1","199","117","316","62.974683544303800","37.0253164556962000","HOMEM"
"250750705000314","1","104","76","180","57.777777777777780","42.2222222222222200","HOMEM"
"250750705000315","1","126","69","195","64.615384615384610","35.3846153846153900","HOMEM"
"250750705000316","1","120","89","209","57.416267942583730","42.5837320574162700","HOMEM"
"250750705000317","1","127","78","205","61.951219512195124","38.0487804878048760","HOMEM"
"250750705000318","1","103","70","173","59.537572254335260","40.4624277456647400","HOMEM"
"250750705000319","1","31","91","122","25.409836065573770","74.5901639344262300","MULHER"
"250750705000320","1","124","73","197","62.944162436548226","37.0558375634517740","HOMEM"
"250750705000321","1","136","51","187","72.727272727272730","27.2727272727272730","HOMEM"
"250750705000322","1","186","186","372","50.000000000000000","50.0000000000000000","IGUAL"
"250750705000323","1","165","97","262","62.977099236641220","37.0229007633587800","HOMEM"
"250750705000324","1","120","62","182","65.934065934065930","34.0659340659340660","HOMEM"
"250750705000325","1","176","122","298","59.060402684563755","40.9395973154362450","HOMEM"
"250750705000326","1","53","40","93","56.989247311827960","43.0107526881720400","HOMEM"
"250750705000327","1","90","77","167","53.892215568862280","46.1077844311377200","HOMEM"
"250750705000328","1","138","77","215","64.186046511627910","35.8139534883720900","HOMEM"
"250750705000329","1","184","141","325","56.615384615384610","43.3846153846153900","HOMEM"
"250750705000330","1","153","132","285","53.684210526315790","46.3157894736842100","HOMEM"
"250750705000331","1","99","68","167","59.281437125748500","40.7185628742515000","HOMEM"
"250750705000332","1","118","56","174","67.816091954023000","32.1839080459770100","HOMEM"
"250750705000333","1","107","108","215","49.767441860465120","50.2325581395348800","MULHER"
"250750705000334","1","103","96","199","51.758793969849240","48.2412060301507600","HOMEM"
"250750705000335","1","159","184","343","46.355685131195340","53.6443148688046600","MULHER"
"250750705000336","1","91","98","189","48.148148148148145","51.8518518518518550","MULHER"
"250750705000337","1","167","119","286","58.391608391608390","41.6083916083916100","HOMEM"
"250750705000338","1","154","84","238","64.705882352941170","35.2941176470588260","HOMEM"
"250750705000339","1","158","109","267","59.176029962546814","40.8239700374531860","HOMEM"
"250750705000340","1","207","145","352","58.806818181818180","41.1931818181818200","HOMEM"
"250750705000341","1","177","92","269","65.799256505576210","34.2007434944237900","HOMEM"
"250750705000342","1","116","137","253","45.849802371541500","54.1501976284585000","MULHER"
"250750705000343","1","192","121","313","61.341853035143770","38.6581469648562300","HOMEM"
"250750705000344","1","166","114","280","59.285714285714285","40.7142857142857150","HOMEM"
"250750705000345","1","130","90","220","59.090909090909090","40.9090909090909100","HOMEM"
"250750705000346","1","189","177","366","51.639344262295080","48.3606557377049200","HOMEM"
"250750705000347","1","148","215","363","40.771349862258950","59.2286501377410500","MULHER"
"250750705000348","1","72","135","207","34.782608695652170","65.2173913043478300","MULHER"
"250750705000349","1","140","120","260","53.846153846153850","46.1538461538461500","HOMEM"
"250750705000350","1","152","127","279","54.480286738351250","45.5197132616487500","HOMEM"
"250750705000351","1","141","125","266","53.007518796992480","46.9924812030075200","HOMEM"
"250750705000352","1","117","98","215","54.418604651162790","45.5813953488372100","HOMEM"
"250750705000353","1","104","73","177","58.757062146892660","41.2429378531073400","HOMEM"
"250750705000354","1","271","91","362","74.861878453038670","25.1381215469613260","HOMEM"
"250750705000355","1","107","59","166","64.457831325301200","35.5421686746987900","HOMEM"
"250750705000356","1","160","52","212","75.471698113207550","24.5283018867924520","HOMEM"
"250750705000357","1","195","85","280","69.642857142857140","30.3571428571428580","HOMEM"
"250750705000358","1","130","58","188","69.148936170212760","30.8510638297872330","HOMEM"
"250750705000359","1","271","112","383","70.757180156657970","29.2428198433420370","HOMEM"
"250750705000360","1","75","115","190","39.473684210526315","60.5263157894736850","MULHER"
"250750705000361","1","168","131","299","56.187290969899664","43.8127090301003360","HOMEM"
"250750705000362","1","172","113","285","60.350877192982460","39.6491228070175400","HOMEM"
"250750705000363","1","128","117","245","52.244897959183675","47.7551020408163250","HOMEM"
"250750705000364","1","111","121","232","47.844827586206900","52.1551724137931000","MULHER"
"250750705000365","1","184","142","326","56.441717791411044","43.5582822085889560","HOMEM"
"250750705000366","1","105","83","188","55.851063829787236","44.1489361702127640","HOMEM"
"250750705000367","1","93","87","180","51.666666666666664","48.3333333333333360","HOMEM"
"250750705000368","1","228","172","400","57.000000000000000","43.0000000000000000","HOMEM"
"250750705000369","1","130","124","254","51.181102362204726","48.8188976377952740","HOMEM"
"250750705000370","1","115","147","262","43.893129770992370","56.1068702290076300","MULHER"
"250750705000371","1","130","131","261","49.808429118773944","50.1915708812260560","MULHER"
"250750705000372","1","107","77","184","58.152173913043480","41.8478260869565200","HOMEM"
"250750705000373","1","202","155","357","56.582633053221286","43.4173669467787140","HOMEM"
"250750705000374","1","163","132","295","55.254237288135590","44.7457627118644100","HOMEM"
"250750705000375","1","76","144","220","34.545454545454550","65.4545454545454500","MULHER"
"250750705000376","1","190","116","306","62.091503267973856","37.9084967320261440","HOMEM"
"250750705000377","1","131","62","193","67.875647668393780","32.1243523316062200","HOMEM"
"250750705000378","1","46","30","76","60.526315789473685","39.4736842105263150","HOMEM"
"250750705000379","1","25","39","64","39.062500000000000","60.9375000000000000","MULHER"
"250750705000380","1","102","100","202","50.495049504950494","49.5049504950495060","HOMEM"
"250750705000381","1","139","99","238","58.403361344537814","41.5966386554621860","HOMEM"
"250750705000382","1","118","72","190","62.105263157894740","37.8947368421052600","HOMEM"
"250750705000383","1","177","129","306","57.843137254901960","42.1568627450980400","HOMEM"
"250750705000384","1","124","86","210","59.047619047619050","40.9523809523809500","HOMEM"
"250750705000385","1","152","99","251","60.557768924302790","39.4422310756972100","HOMEM"
"250750705000386","1","144","100","244","59.016393442622950","40.9836065573770500","HOMEM"
"250750705000387","1","120","99","219","54.794520547945204","45.2054794520547960","HOMEM"
"250750705000388","1","115","108","223","51.569506726457400","48.4304932735426000","HOMEM"
"250750705000389","1","132","72","204","64.705882352941170","35.2941176470588260","HOMEM"
"250750705000390","1","175","94","269","65.055762081784380","34.9442379182156100","HOMEM"
"250750705000391","1","170","84","254","66.929133858267720","33.0708661417322800","HOMEM"
"250750705000392","1","130","103","233","55.793991416309010","44.2060085836909900","HOMEM"
"250750705000393","1","157","121","278","56.474820143884890","43.5251798561151100","HOMEM"
"250750705000394","1","144","130","274","52.554744525547450","47.4452554744525500","HOMEM"
"250750705000395","1","158","124","282","56.028368794326240","43.9716312056737600","HOMEM"
"250750705000396","1","95","228","323","29.411764705882350","70.5882352941176500","MULHER"
"250750705000397","1","152","132","284","53.521126760563384","46.4788732394366160","HOMEM"
"250750705000398","1","153","97","250","61.200000000000000","38.8000000000000000","HOMEM"
"250750705000399","1","162","114","276","58.695652173913050","41.3043478260869500","HOMEM"
"250750705000400","1","142","190","332","42.771084337349400","57.2289156626506000","MULHER"
"250750705000401","1","144","144","288","50.000000000000000","50.0000000000000000","IGUAL"
"250750705000402","1","175","75","250","70.000000000000000","30.0000000000000000","HOMEM"
"250750705000403","1","174","147","321","54.205607476635514","45.7943925233644860","HOMEM"
"250750705000404","1","196","107","303","64.686468646864680","35.3135313531353100","HOMEM"
"250750705000405","1","129","75","204","63.235294117647060","36.7647058823529400","HOMEM"
"250750705000406","1","239","115","354","67.514124293785310","32.4858757062146900","HOMEM"
"250750705000407","1","106","71","177","59.887005649717516","40.1129943502824840","HOMEM"
"250750705000408","1","198","129","327","60.550458715596330","39.4495412844036700","HOMEM"
"250750705000409","1","206","115","321","64.174454828660430","35.8255451713395600","HOMEM"
"250750705000410","1","164","113","277","59.205776173285200","40.7942238267148000","HOMEM"
"250750705000411","1","142","53","195","72.820512820512820","27.1794871794871800","HOMEM"
"250750705000412","1","150","167","317","47.318611987381700","52.6813880126183000","MULHER"
"250750705000413","1","112","58","170","65.882352941176460","34.1176470588235300","HOMEM"
"250750705000414","1","157","162","319","49.216300940438870","50.7836990595611300","MULHER"
"250750705000415","1","152","77","229","66.375545851528390","33.6244541484716140","HOMEM"
"250750705000416","1","178","137","315","56.507936507936506","43.4920634920634940","HOMEM"
"250750705000417","1","155","100","255","60.784313725490190","39.2156862745098100","HOMEM"
"250750705000418","1","139","60","199","69.849246231155770","30.1507537688442220","HOMEM"
"250750705000419","1","103","104","207","49.758454106280190","50.2415458937198100","MULHER"
"250750705000420","1","213","142","355","60.000000000000000","40.0000000000000000","HOMEM"
"250750705000421","1","9","3","12","75.000000000000000","25.0000000000000000","HOMEM"
"250750705000422","1","254","102","356","71.348314606741570","28.6516853932584250","HOMEM"
"250750705000423","1","289","92","381","75.853018372703420","24.1469816272965860","HOMEM"
"250750705000424","1","0","0","0",NULL,NULL,NULL
"250750705000425","1","153","84","237","64.556962025316450","35.4430379746835400","HOMEM"
"250750705000426","1","36","128","164","21.951219512195124","78.0487804878048800","MULHER"
"250750705000427","1","29","68","97","29.896907216494846","70.1030927835051600","MULHER"
"250750705000428","1","237","121","358","66.201117318435750","33.7988826815642440","HOMEM"
"250750705000429","1","91","144","235","38.723404255319146","61.2765957446808540","MULHER"
"250750705000430","1","173","121","294","58.843537414965986","41.1564625850340140","HOMEM"
"250750705000431","1","207","135","342","60.526315789473685","39.4736842105263150","HOMEM"
"250750705000432","1","174","103","277","62.815884476534290","37.1841155234657100","HOMEM"
"250750705000433","1","120","76","196","61.224489795918366","38.7755102040816340","HOMEM"
"250750705000434","1","231","93","324","71.296296296296290","28.7037037037037020","HOMEM"
"250750705000435","1","93","56","149","62.416107382550340","37.5838926174496600","HOMEM"
"250750705000436","1","96","83","179","53.631284916201120","46.3687150837988800","HOMEM"
"250750705000437","1","120","75","195","61.538461538461540","38.4615384615384600","HOMEM"
"250750705000438","1","144","54","198","72.727272727272730","27.2727272727272730","HOMEM"
"250750705000439","1","176","90","266","66.165413533834580","33.8345864661654100","HOMEM"
"250750705000440","1","111","150","261","42.528735632183910","57.4712643678160900","MULHER"
"250750705000441","1","123","168","291","42.268041237113400","57.7319587628866000","MULHER"
"250750705000442","1","132","117","249","53.012048192771080","46.9879518072289200","HOMEM"
"250750705000443","1","43","30","73","58.904109589041100","41.0958904109589000","HOMEM"
"250750705000444","1","95","70","165","57.575757575757580","42.4242424242424200","HOMEM"
"250750705000445","1","78","42","120","65.000000000000000","35.0000000000000000","HOMEM"
"250750705000446","1","202","137","339","59.587020648967550","40.4129793510324500","HOMEM"
"250750705000447","1","158","129","287","55.052264808362370","44.9477351916376300","HOMEM"
"250750705000448","1","169","113","282","59.929078014184400","40.0709219858156000","HOMEM"
"250750705000449","1","121","34","155","78.064516129032260","21.9354838709677400","HOMEM"
"250750705000450","1","117","83","200","58.500000000000000","41.5000000000000000","HOMEM"
"250750705000451","1","130","90","220","59.090909090909090","40.9090909090909100","HOMEM"
"250750705000452","1","92","38","130","70.769230769230770","29.2307692307692300","HOMEM"
"250750705000453","1","167","95","262","63.740458015267170","36.2595419847328300","HOMEM"
"250750705000454","1","167","143","310","53.870967741935480","46.1290322580645200","HOMEM"
"250750705000455","1","207","98","305","67.868852459016400","32.1311475409836050","HOMEM"
"250750705000456","1","175","115","290","60.344827586206900","39.6551724137931000","HOMEM"
"250750705000457","1","179","111","290","61.724137931034484","38.2758620689655160","HOMEM"
"250750705000458","1","148","126","274","54.014598540145980","45.9854014598540200","HOMEM"
"250750705000459","1","124","109","233","53.218884120171670","46.7811158798283300","HOMEM"
"250750705000460","1","152","134","286","53.146853146853150","46.8531468531468500","HOMEM"
"250750705000461","1","171","146","317","53.943217665615144","46.0567823343848560","HOMEM"
"250750705000462","1","106","53","159","66.666666666666670","33.3333333333333360","HOMEM"
"250750705000463","1","132","145","277","47.653429602888090","52.3465703971119100","MULHER"
"250750705000464","1","139","108","247","56.275303643724700","43.7246963562753000","HOMEM"
"250750705000465","1","150","96","246","60.975609756097560","39.0243902439024400","HOMEM"
"250750705000466","1","163","56","219","74.429223744292240","25.5707762557077630","HOMEM"
"250750705000467","1","172","100","272","63.235294117647060","36.7647058823529400","HOMEM"
"250750705000468","1","131","89","220","59.545454545454550","40.4545454545454500","HOMEM"
"250750705000469","1","100","72","172","58.139534883720930","41.8604651162790700","HOMEM"
"250750705000470","1","188","165","353","53.257790368271955","46.7422096317280450","HOMEM"
"250750705000471","1","166","117","283","58.657243816254415","41.3427561837455850","HOMEM"
"250750705000472","1","75","61","136","55.147058823529410","44.8529411764705900","HOMEM"
"250750705000473","1","211","84","295","71.525423728813560","28.4745762711864400","HOMEM"
"250750705000474","1","136","83","219","62.100456621004570","37.8995433789954300","HOMEM"
"250750705000475","1","186","123","309","60.194174757281550","39.8058252427184500","HOMEM"
"250750705000476","1","172","127","299","57.525083612040135","42.4749163879598650","HOMEM"
"250750705000477","1","208","113","321","64.797507788162000","35.2024922118380060","HOMEM"
"250750705000478","1","105","68","173","60.693641618497110","39.3063583815028900","HOMEM"
"250750705000479","1","159","150","309","51.456310679611650","48.5436893203883500","HOMEM"
"250750705000480","1","109","93","202","53.960396039603964","46.0396039603960360","HOMEM"
"250750705000481","1","72","54","126","57.142857142857146","42.8571428571428540","HOMEM"
"250750705000482","1","137","203","340","40.294117647058826","59.7058823529411740","MULHER"
"250750705000483","1","196","113","309","63.430420711974110","36.5695792880258900","HOMEM"
"250750705000484","1","68","46","114","59.649122807017540","40.3508771929824600","HOMEM"
"250750705000485","1","89","81","170","52.352941176470590","47.6470588235294100","HOMEM"
"250750705000486","1","96","58","154","62.337662337662340","37.6623376623376600","HOMEM"
"250750705000487","1","95","65","160","59.375000000000000","40.6250000000000000","HOMEM"
"250750705000488","1","48","42","90","53.333333333333336","46.6666666666666640","HOMEM"
"250750705000489","1","47","34","81","58.024691358024690","41.9753086419753100","HOMEM"
"250750705000490","1","131","92","223","58.744394618834080","41.2556053811659200","HOMEM"
"250750705000491","1","194","129","323","60.061919504643960","39.9380804953560400","HOMEM"
"250750705000492","1","45","135","180","25.000000000000000","75.0000000000000000","MULHER"
"250750705000493","1","62","45","107","57.943925233644860","42.0560747663551400","HOMEM"
"250750705000494","1","125","56","181","69.060773480662990","30.9392265193370160","HOMEM"
"250750705000495","1","150","153","303","49.504950495049506","50.4950495049504940","MULHER"
"250750705000496","1","138","87","225","61.333333333333336","38.6666666666666640","HOMEM"
"250750705000497","1","178","88","266","66.917293233082700","33.0827067669172900","HOMEM"
"250750705000498","1","136","108","244","55.737704918032790","44.2622950819672100","HOMEM"
"250750705000499","1","71","60","131","54.198473282442750","45.8015267175572500","HOMEM"
"250750705000500","1","324","133","457","70.897155361050320","29.1028446389496730","HOMEM"
"250750705000501","1","135","89","224","60.267857142857146","39.7321428571428540","HOMEM"
"250750705000502","1","155","91","246","63.008130081300810","36.9918699186991900","HOMEM"
"250750705000503","1","90","70","160","56.250000000000000","43.7500000000000000","HOMEM"
"250750705000504","1","212","67","279","75.985663082437270","24.0143369175627230","HOMEM"
"250750705000505","1","131","47","178","73.595505617977520","26.4044943820224700","HOMEM"
"250750705000506","1","111","89","200","55.500000000000000","44.5000000000000000","HOMEM"
"250750705000507","1","195","141","336","58.035714285714285","41.9642857142857150","HOMEM"
"250750705000508","1","338","171","509","66.404715127701380","33.5952848722986300","HOMEM"
"250750705000509","1","181","99","280","64.642857142857140","35.3571428571428540","HOMEM"
"250750705000510","1","181","112","293","61.774744027303754","38.2252559726962460","HOMEM"
"250750705000511","1","153","92","245","62.448979591836730","37.5510204081632700","HOMEM"
"250750705000512","8","35","8","43","81.395348837209300","18.6046511627907000","HOMEM"
"250750705000513","4","89","46","135","65.925925925925920","34.0740740740740760","HOMEM"
"250750705000514","8","231","65","296","78.040540540540550","21.9594594594594600","HOMEM"
"250750705000515","1","229","102","331","69.184290030211490","30.8157099697885180","HOMEM"
"250750705000516","8","5","6","11","45.454545454545450","54.5454545454545500","MULHER"
"250750705000517","1","77","128","205","37.560975609756100","62.4390243902439000","MULHER"
"250750705000518","1","257","111","368","69.836956521739130","30.1630434782608700","HOMEM"
"250750705000519","1","54","62","116","46.551724137931030","53.4482758620689700","MULHER"
"250750705000520","1","116","161","277","41.877256317689530","58.1227436823104700","MULHER"
"250750705000521","1","185","93","278","66.546762589928050","33.4532374100719400","HOMEM"
"250750705000522","1","172","234","406","42.364532019704434","57.6354679802955660","MULHER"
"250750705000523","1","126","137","263","47.908745247148290","52.0912547528517100","MULHER"
"250750705000524","1","132","129","261","50.574712643678160","49.4252873563218400","HOMEM"
"250750705000525","1","57","29","86","66.279069767441850","33.7209302325581400","HOMEM"
"250750705000526","1","103","52","155","66.451612903225810","33.5483870967741900","HOMEM"
"250750705000527","1","120","61","181","66.298342541436470","33.7016574585635400","HOMEM"
"250750705000528","1","174","86","260","66.923076923076920","33.0769230769230800","HOMEM"
"250750705000529","1","177","76","253","69.960474308300390","30.0395256916996050","HOMEM"
"250750705000530","1","141","97","238","59.243697478991600","40.7563025210084000","HOMEM"
"250750705000531","1","156","113","269","57.992565055762080","42.0074349442379200","HOMEM"
"250750705000532","1","90","75","165","54.545454545454550","45.4545454545454500","HOMEM"
"250750705000533","1","68","42","110","61.818181818181820","38.1818181818181800","HOMEM"
"250750705000534","1","129","52","181","71.270718232044200","28.7292817679558000","HOMEM"
"250750705000535","1","124","62","186","66.666666666666670","33.3333333333333360","HOMEM"
"250750705000536","1","159","83","242","65.702479338842980","34.2975206611570200","HOMEM"
"250750705000537","1","178","93","271","65.682656826568260","34.3173431734317400","HOMEM"
"250750705000538","1","211","101","312","67.628205128205120","32.3717948717948700","HOMEM"
"250750705000539","1","127","116","243","52.263374485596710","47.7366255144032900","HOMEM"
"250750705000540","1","88","52","140","62.857142857142854","37.1428571428571460","HOMEM"
"250750705000541","1","147","79","226","65.044247787610620","34.9557522123893800","HOMEM"
"250750705000542","1","136","74","210","64.761904761904760","35.2380952380952400","HOMEM"
"250750705000543","1","90","53","143","62.937062937062940","37.0629370629370600","HOMEM"
"250750705000544","1","156","123","279","55.913978494623656","44.0860215053763440","HOMEM"
"250750705000545","1","43","57","100","43.000000000000000","57.0000000000000000","MULHER"
"250750705000546","1","107","109","216","49.537037037037040","50.4629629629629600","MULHER"
"250750705000547","1","110","94","204","53.921568627450980","46.0784313725490200","HOMEM"
"250750705000548","1","169","152","321","52.647975077881620","47.3520249221183800","HOMEM"
"250750705000549","1","135","177","312","43.269230769230770","56.7307692307692300","MULHER"
"250750705000550","1","113","87","200","56.500000000000000","43.5000000000000000","HOMEM"
"250750705000551","1","170","136","306","55.555555555555560","44.4444444444444400","HOMEM"
"250750705000552","1","132","84","216","61.111111111111114","38.8888888888888860","HOMEM"
"250750705000553","1","89","118","207","42.995169082125610","57.0048309178743900","MULHER"
"250750705000554","1","179","120","299","59.866220735785950","40.1337792642140500","HOMEM"
"250750705000555","1","114","82","196","58.163265306122450","41.8367346938775500","HOMEM"
"250750705000556","1","96","86","182","52.747252747252745","47.2527472527472550","HOMEM"
"250750705000557","1","99","66","165","60.000000000000000","40.0000000000000000","HOMEM"
"250750705000558","1","79","33","112","70.535714285714290","29.4642857142857150","HOMEM"
"250750705000559","1","90","38","128","70.312500000000000","29.6875000000000000","HOMEM"
"250750705000560","1","138","67","205","67.317073170731700","32.6829268292682900","HOMEM"
"250750705000561","1","71","20","91","78.021978021978030","21.9780219780219780","HOMEM"
"250750705000562","8","0","0","0",NULL,NULL,NULL
"250750705000563","8","94","6","100","94.000000000000000","6.0000000000000000","HOMEM"
"250750705000564","1","81","34","115","70.434782608695660","29.5652173913043480","HOMEM"
"250750705000565","1","41","54","95","43.157894736842100","56.8421052631579000","MULHER"
"250750705000566","1","0","0","0",NULL,NULL,NULL
"250750705000567","1","0","0","0",NULL,NULL,NULL
"250750705000569","1","0","0","0",NULL,NULL,NULL
"250750705000570","1","0","0","0",NULL,NULL,NULL
"250750705000571","1","167","101","268","62.313432835820900","37.6865671641791000","HOMEM"
"250750705000572","1","37","34","71","52.112676056338030","47.8873239436619700","HOMEM"
"250750705000573","1","13","9","22","59.090909090909090","40.9090909090909100","HOMEM"
"250750705000574","1","64","41","105","60.952380952380950","39.0476190476190500","HOMEM"
"250750705000575","1","100","107","207","48.309178743961354","51.6908212560386460","MULHER"
"250750705000576","1","107","111","218","49.082568807339450","50.9174311926605500","MULHER"
"250750705000577","1","0","0","0",NULL,NULL,NULL
"250750705000578","1","77","66","143","53.846153846153850","46.1538461538461500","HOMEM"
"250750705000579","1","40","34","74","54.054054054054056","45.9459459459459440","HOMEM"
"250750705000580","1","143","149","292","48.972602739726030","51.0273972602739700","MULHER"
"250750705000581","1","133","115","248","53.629032258064520","46.3709677419354800","HOMEM"
"250750705000582","1","154","83","237","64.978902953586500","35.0210970464135000","HOMEM"
"250750705000583","1","116","87","203","57.142857142857146","42.8571428571428540","HOMEM"
"250750705000584","1","0","0","0",NULL,NULL,NULL
"250750705000585","1","34","39","73","46.575342465753420","53.4246575342465800","MULHER"
"250750705000586","1","0","0","0",NULL,NULL,NULL
"250750705000587","1","0","0","0",NULL,NULL,NULL
"250750705000588","1","0","0","0",NULL,NULL,NULL
"250750705000589","1","82","70","152","53.947368421052630","46.0526315789473700","HOMEM"
"250750705000590","1","37","29","66","56.060606060606060","43.9393939393939400","HOMEM"
"250750705000592","1","72","32","104","69.230769230769230","30.7692307692307700","HOMEM"
"250750705000593","1","53","50","103","51.456310679611650","48.5436893203883500","HOMEM"
"250750705000594","1","63","63","126","50.000000000000000","50.0000000000000000","IGUAL"
"250750705000595","1","83","74","157","52.866242038216560","47.1337579617834400","HOMEM"
"250750705000596","1","150","106","256","58.593750000000000","41.4062500000000000","HOMEM"
"250750705000597","1","174","105","279","62.365591397849464","37.6344086021505360","HOMEM"
"250750705000598","1","72","151","223","32.286995515695070","67.7130044843049300","MULHER"
"250750705000599","1","186","121","307","60.586319218241044","39.4136807817589560","HOMEM"
"250750705000600","1","127","161","288","44.097222222222220","55.9027777777777800","MULHER"
"250750705000601","1","158","114","272","58.088235294117645","41.9117647058823550","HOMEM"
"250750705000602","1","221","134","355","62.253521126760560","37.7464788732394400","HOMEM"
"250750705000603","1","86","59","145","59.310344827586206","40.6896551724137940","HOMEM"
"250750705000604","1","207","80","287","72.125435540069690","27.8745644599303120","HOMEM"
"250750705000605","1","44","102","146","30.136986301369863","69.8630136986301400","MULHER"
"250750705000606","1","192","134","326","58.895705521472394","41.1042944785276060","HOMEM"
"250750705000607","1","167","114","281","59.430604982206404","40.5693950177935960","HOMEM"
"250750705000608","1","62","29","91","68.131868131868130","31.8681318681318700","HOMEM"
"250750705000609","1","238","104","342","69.590643274853800","30.4093567251462000","HOMEM"
"250750705000610","1","139","32","171","81.286549707602330","18.7134502923976600","HOMEM"
"250750705000611","8","28","3","31","90.322580645161300","9.6774193548387100","HOMEM"
"250750705000612","1","97","213","310","31.290322580645160","68.7096774193548300","MULHER"
"250750705000613","1","111","51","162","68.518518518518520","31.4814814814814800","HOMEM"
"250750705000614","1","139","73","212","65.566037735849050","34.4339622641509400","HOMEM"
"250750705000615","1","172","69","241","71.369294605809130","28.6307053941908730","HOMEM"
"250750705000616","1","135","133","268","50.373134328358210","49.6268656716417900","HOMEM"
"250750705000617","1","231","155","386","59.844559585492230","40.1554404145077700","HOMEM"
"250750705000618","1","83","137","220","37.727272727272730","62.2727272727272700","MULHER"
"250750705000619","1","248","96","344","72.093023255813950","27.9069767441860460","HOMEM"
"250750705000620","1","122","89","211","57.819905213270140","42.1800947867298600","HOMEM"
"250750705000621","1","75","116","191","39.267015706806280","60.7329842931937200","MULHER"
"250750705000622","1","75","79","154","48.701298701298704","51.2987012987012960","MULHER"
"250750705000623","1","118","89","207","57.004830917874390","42.9951690821256100","HOMEM"
"250750705000624","1","88","102","190","46.315789473684210","53.6842105263157900","MULHER"
"250750705000625","1","98","81","179","54.748603351955310","45.2513966480446900","HOMEM"
"250750705000626","1","144","81","225","64.000000000000000","36.0000000000000000","HOMEM"
"250750705000627","1","115","127","242","47.520661157024790","52.4793388429752100","MULHER"
"250750705000628","1","103","102","205","50.243902439024390","49.7560975609756100","HOMEM"
"250750705000629","1","179","95","274","65.328467153284680","34.6715328467153300","HOMEM"
"250750705000630","1","196","100","296","66.216216216216210","33.7837837837837800","HOMEM"
"250750705000631","1","252","127","379","66.490765171503950","33.5092348284960400","HOMEM"
"250750705000632","1","0","0","0",NULL,NULL,NULL
"250750705000633","1","105","76","181","58.011049723756905","41.9889502762430950","HOMEM"
"250750705000634","1","205","81","286","71.678321678321680","28.3216783216783230","HOMEM"
"250750705000635","1","175","58","233","75.107296137339060","24.8927038626609440","HOMEM"
"250750705000637","1","60","84","144","41.666666666666664","58.3333333333333360","MULHER"
"250750705000639","1","128","106","234","54.700854700854700","45.2991452991453000","HOMEM"
"250750705000640","1","115","93","208","55.288461538461540","44.7115384615384600","HOMEM"
"250750705000641","1","48","37","85","56.470588235294116","43.5294117647058840","HOMEM"
"250750705000642","1","114","86","200","57.000000000000000","43.0000000000000000","HOMEM"
"250750705000643","1","85","53","138","61.594202898550726","38.4057971014492740","HOMEM"
"250750705000644","1","192","177","369","52.032520325203250","47.9674796747967500","HOMEM"
"250750705000645","1","170","93","263","64.638783269961980","35.3612167300380240","HOMEM"
"250750705000646","1","109","73","182","59.890109890109890","40.1098901098901100","HOMEM"
"250750705000647","1","167","89","256","65.234375000000000","34.7656250000000000","HOMEM"
"250750705000648","1","76","43","119","63.865546218487395","36.1344537815126050","HOMEM"
"250750705000649","1","39","30","69","56.521739130434780","43.4782608695652200","HOMEM"
"250750705000650","1","124","63","187","66.310160427807490","33.6898395721925100","HOMEM"
"250750705000651","1","108","84","192","56.250000000000000","43.7500000000000000","HOMEM"
"250750705000652","1","59","34","93","63.440860215053760","36.5591397849462400","HOMEM"
"250750705000653","1","34","66","100","34.000000000000000","66.0000000000000000","MULHER"
"250750705000654","1","4","5","9","44.444444444444440","55.5555555555555600","MULHER"
"250750705000655","1","61","67","128","47.656250000000000","52.3437500000000000","MULHER"
"250750705000656","1","111","70","181","61.325966850828730","38.6740331491712700","HOMEM"
"250750705000657","1","83","88","171","48.538011695906434","51.4619883040935660","MULHER"
"250750705000658","1","101","92","193","52.331606217616580","47.6683937823834200","HOMEM"
"250750705000659","1","71","77","148","47.972972972972975","52.0270270270270250","MULHER"
"250750705000660","1","92","70","162","56.790123456790130","43.2098765432098700","HOMEM"
"250750705000661","1","227","124","351","64.672364672364680","35.3276353276353300","HOMEM"
"250750705000662","1","93","70","163","57.055214723926380","42.9447852760736200","HOMEM"
"250750705000663","1","71","33","104","68.269230769230770","31.7307692307692300","HOMEM"
"250750705000664","1","102","150","252","40.476190476190474","59.5238095238095260","MULHER"
"250750705000665","1","82","90","172","47.674418604651166","52.3255813953488340","MULHER"
"250750705000666","1","194","116","310","62.580645161290320","37.4193548387096800","HOMEM"
"250750705000667","1","58","53","111","52.252252252252255","47.7477477477477450","HOMEM"
"250750705000668","1","6","2","8","75.000000000000000","25.0000000000000000","HOMEM"
"250750705000669","1","69","153","222","31.081081081081080","68.9189189189189200","MULHER"
"250750705000670","1","186","89","275","67.636363636363640","32.3636363636363700","HOMEM"
"250750705000671","1","24","2","26","92.307692307692300","7.6923076923076925","HOMEM"
"250750705000672","1","90","119","209","43.062200956937800","56.9377990430622000","MULHER"
"250750705000673","1","130","77","207","62.801932367149760","37.1980676328502400","HOMEM"
"250750705000674","1","114","113","227","50.220264317180614","49.7797356828193860","HOMEM"
"250750705000675","1","122","185","307","39.739413680781760","60.2605863192182400","MULHER"
"250750705000676","1","132","90","222","59.459459459459460","40.5405405405405400","HOMEM"
"250750705000677","1","102","87","189","53.968253968253970","46.0317460317460300","HOMEM"
"250750705000678","1","89","72","161","55.279503105590060","44.7204968944099400","HOMEM"
"250750705000679","1","127","94","221","57.466063348416290","42.5339366515837100","HOMEM"
"250750705000680","1","66","117","183","36.065573770491800","63.9344262295082000","MULHER"
"250750705000681","1","40","106","146","27.397260273972602","72.6027397260274000","MULHER"
"250750705000682","1","91","101","192","47.395833333333336","52.6041666666666640","MULHER"
"250750705000683","1","100","89","189","52.910052910052910","47.0899470899470900","HOMEM"
"250750705000684","1","184","91","275","66.909090909090900","33.0909090909090900","HOMEM"
"250750705000685","1","281","60","341","82.404692082111440","17.5953079178885600","HOMEM"
"250750705000686","1","176","171","347","50.720461095100866","49.2795389048991340","HOMEM"
"250750705000687","1","242","97","339","71.386430678466070","28.6135693215339230","HOMEM"
"250750705000688","1","179","151","330","54.242424242424240","45.7575757575757600","HOMEM"
"250750705000689","1","217","103","320","67.812500000000000","32.1875000000000000","HOMEM"
"250750705000690","4","100","42","142","70.422535211267600","29.5774647887323960","HOMEM"
"250750705000691","1","29","9","38","76.315789473684200","23.6842105263157900","HOMEM"
"250750705000692","1","199","75","274","72.627737226277380","27.3722627737226300","HOMEM"
"250750705000693","1","156","82","238","65.546218487394950","34.4537815126050400","HOMEM"
"250750705000694","1","214","101","315","67.936507936507940","32.0634920634920600","HOMEM"
"250750705000695","1","230","123","353","65.155807365439090","34.8441926345609050","HOMEM"
"250750705000696","1","190","123","313","60.702875399361020","39.2971246006389800","HOMEM"
"250750705000697","1","201","82","283","71.024734982332150","28.9752650176678440","HOMEM"
"250750705000698","1","124","34","158","78.481012658227850","21.5189873417721530","HOMEM"
"250750705000699","1","136","46","182","74.725274725274730","25.2747252747252740","HOMEM"
"250750705000700","1","136","91","227","59.911894273127750","40.0881057268722500","HOMEM"
"250750705000701","1","127","111","238","53.361344537815130","46.6386554621848700","HOMEM"
"250750705000702","1","72","83","155","46.451612903225810","53.5483870967741900","MULHER"
"250750705000703","1","132","72","204","64.705882352941170","35.2941176470588260","HOMEM"
"250750705000704","1","93","109","202","46.039603960396036","53.9603960396039640","MULHER"
"250750705000705","1","73","136","209","34.928229665071770","65.0717703349282300","MULHER"
"250750705000706","1","158","70","228","69.298245614035080","30.7017543859649100","HOMEM"
"250750705000707","1","60","52","112","53.571428571428570","46.4285714285714300","HOMEM"
"250750705000708","1","159","93","252","63.095238095238095","36.9047619047619050","HOMEM"
"250750705000709","1","117","57","174","67.241379310344830","32.7586206896551740","HOMEM"
"250750705000710","1","136","74","210","64.761904761904760","35.2380952380952400","HOMEM"
"250750705000711","1","117","125","242","48.347107438016530","51.6528925619834700","MULHER"
"250750705000712","1","144","86","230","62.608695652173914","37.3913043478260860","HOMEM"
"250750705000713","1","111","71","182","60.989010989010985","39.0109890109890150","HOMEM"
"250750705000714","1","159","121","280","56.785714285714285","43.2142857142857150","HOMEM"
"250750705000715","1","180","78","258","69.767441860465110","30.2325581395348840","HOMEM"
"250750705000716","1","293","107","400","73.250000000000000","26.7500000000000000","HOMEM"
"250750705000717","1","93","64","157","59.235668789808920","40.7643312101910800","HOMEM"
"250750705000718","1","133","89","222","59.909909909909906","40.0900900900900940","HOMEM"
"250750705000719","1","127","56","183","69.398907103825140","30.6010928961748620","HOMEM"
"250750705000720","1","115","87","202","56.930693069306930","43.0693069306930700","HOMEM"
"250750705000721","1","152","47","199","76.381909547738690","23.6180904522613060","HOMEM"
"250750705000722","1","150","53","203","73.891625615763540","26.1083743842364520","HOMEM"
"250750705000723","1","131","60","191","68.586387434554980","31.4136125654450250","HOMEM"
"250750705000724","1","4","4","8","50.000000000000000","50.0000000000000000","IGUAL"
"250750705000725","1","109","54","163","66.871165644171780","33.1288343558282200","HOMEM"
"250750705000726","1","73","87","160","45.625000000000000","54.3750000000000000","MULHER"
"250750705000727","1","80","142","222","36.036036036036040","63.9639639639639600","MULHER"
"250750705000728","1","135","112","247","54.655870445344130","45.3441295546558700","HOMEM"
"250750705000729","1","95","104","199","47.738693467336680","52.2613065326633200","MULHER"
"250750705000730","1","183","112","295","62.033898305084750","37.9661016949152500","HOMEM"
"250750705000731","1","176","125","301","58.471760797342190","41.5282392026578100","HOMEM"
"250750705000732","1","183","67","250","73.200000000000000","26.8000000000000000","HOMEM"
"250750705000733","1","126","58","184","68.478260869565220","31.5217391304347800","HOMEM"
"250750705000734","1","98","80","178","55.056179775280896","44.9438202247191040","HOMEM"
"250750705000735","1","133","106","239","55.648535564853550","44.3514644351464500","HOMEM"
"250750705000736","1","81","81","162","50.000000000000000","50.0000000000000000","IGUAL"
"250750705000737","1","156","78","234","66.666666666666670","33.3333333333333360","HOMEM"
"250750705000738","1","121","59","180","67.222222222222230","32.7777777777777800","HOMEM"
"250750705000739","1","129","109","238","54.201680672268910","45.7983193277310900","HOMEM"
"250750705000740","1","74","53","127","58.267716535433074","41.7322834645669260","HOMEM"
"250750705000741","1","244","96","340","71.764705882352940","28.2352941176470580","HOMEM"
"250750705000742","1","171","57","228","75.000000000000000","25.0000000000000000","HOMEM"
"250750705000743","1","80","61","141","56.737588652482266","43.2624113475177340","HOMEM"
"250750705000744","1","99","66","165","60.000000000000000","40.0000000000000000","HOMEM"
"250750705000745","1","166","77","243","68.312757201646100","31.6872427983539100","HOMEM"
"250750705000746","1","134","112","246","54.471544715447150","45.5284552845528500","HOMEM"
"250750705000747","1","115","80","195","58.974358974358970","41.0256410256410300","HOMEM"
"250750705000748","1","126","84","210","60.000000000000000","40.0000000000000000","HOMEM"
"250750705000749","1","147","96","243","60.493827160493830","39.5061728395061700","HOMEM"
"250750705000750","1","254","105","359","70.752089136490260","29.2479108635097500","HOMEM"
"250750705000751","1","110","199","309","35.598705501618120","64.4012944983818700","MULHER"
"250750705000752","1","159","161","320","49.687500000000000","50.3125000000000000","MULHER"
"250750705000753","1","138","178","316","43.670886075949370","56.3291139240506300","MULHER"
"250750705000754","1","146","181","327","44.648318042813460","55.3516819571865400","MULHER"
"250750705000755","1","150","66","216","69.444444444444440","30.5555555555555570","HOMEM"
"250750705000756","1","106","123","229","46.288209606986900","53.7117903930131000","MULHER"
"250750705000757","1","187","85","272","68.750000000000000","31.2500000000000000","HOMEM"
"250750705000758","1","189","139","328","57.621951219512200","42.3780487804878000","HOMEM"
"250750705000759","1","265","72","337","78.635014836795250","21.3649851632047460","HOMEM"
"250750705000760","1","162","102","264","61.363636363636370","38.6363636363636300","HOMEM"
"250750705000761","1","177","102","279","63.440860215053760","36.5591397849462400","HOMEM"
"250750705000762","1","136","78","214","63.551401869158880","36.4485981308411200","HOMEM"
"250750705000763","1","203","67","270","75.185185185185190","24.8148148148148130","HOMEM"
"250750705000764","1","125","201","326","38.343558282208590","61.6564417177914100","MULHER"
"250750705000765","1","170","89","259","65.637065637065630","34.3629343629343600","HOMEM"
"250750705000766","1","113","66","179","63.128491620111730","36.8715083798882700","HOMEM"
"250750705000767","1","153","95","248","61.693548387096776","38.3064516129032240","HOMEM"
"250750705000768","1","120","51","171","70.175438596491230","29.8245614035087700","HOMEM"
"250750705000769","1","88","41","129","68.217054263565880","31.7829457364341080","HOMEM"
"250750705000770","1","88","119","207","42.512077294685990","57.4879227053140100","MULHER"
"250750705000771","1","73","50","123","59.349593495934960","40.6504065040650400","HOMEM"
"250750705000772","1","61","91","152","40.131578947368420","59.8684210526315800","MULHER"
"250750705000773","1","108","100","208","51.923076923076920","48.0769230769230800","HOMEM"
"250750705000774","1","116","122","238","48.739495798319325","51.2605042016806750","MULHER"
"250750705000775","1","114","82","196","58.163265306122450","41.8367346938775500","HOMEM"
"250750705000776","1","97","82","179","54.189944134078210","45.8100558659217900","HOMEM"
"250750705000777","1","108","98","206","52.427184466019420","47.5728155339805800","HOMEM"
"250750705000778","1","193","176","369","52.303523035230356","47.6964769647696440","HOMEM"
"250750705000779","1","164","158","322","50.931677018633540","49.0683229813664600","HOMEM"
"250750705000780","1","148","179","327","45.259938837920490","54.7400611620795100","MULHER"
"250750705000781","1","214","61","275","77.818181818181810","22.1818181818181830","HOMEM"
"250750705000782","1","5","2","7","71.428571428571430","28.5714285714285730","HOMEM"
"250750705000783","1","88","50","138","63.768115942028984","36.2318840579710160","HOMEM"
"250750705000784","1","117","87","204","57.352941176470590","42.6470588235294100","HOMEM"
"250750705000785","1","121","91","212","57.075471698113205","42.9245283018867950","HOMEM"
"250750705000786","1","82","54","136","60.294117647058826","39.7058823529411740","HOMEM"
"250750705000787","1","89","30","119","74.789915966386560","25.2100840336134450","HOMEM"
"250750705000788","1","99","64","163","60.736196319018404","39.2638036809815960","HOMEM"
"250750705000789","1","98","86","184","53.260869565217390","46.7391304347826100","HOMEM"
"250750705000790","1","77","43","120","64.166666666666670","35.8333333333333360","HOMEM"
"250750705000791","1","106","99","205","51.707317073170735","48.2926829268292650","HOMEM"
"250750705000792","1","119","134","253","47.035573122529640","52.9644268774703600","MULHER"
"250750705000793","1","144","73","217","66.359447004608300","33.6405529953917100","HOMEM"
"250750705000794","1","145","124","269","53.903345724907060","46.0966542750929400","HOMEM"
"250750705000795","1","149","42","191","78.010471204188480","21.9895287958115200","HOMEM"
"250750705000796","1","148","55","203","72.906403940886700","27.0935960591133000","HOMEM"
"250750705000797","1","51","75","126","40.476190476190474","59.5238095238095260","MULHER"
"250750705000798","1","133","44","177","75.141242937853110","24.8587570621468930","HOMEM"
"250750705000799","1","121","53","174","69.540229885057470","30.4597701149425300","HOMEM"
"250750705000800","1","138","72","210","65.714285714285710","34.2857142857142850","HOMEM"
"250750705000801","1","99","45","144","68.750000000000000","31.2500000000000000","HOMEM"
"250750705000802","1","145","99","244","59.426229508196720","40.5737704918032800","HOMEM"
"250750705000803","1","119","91","210","56.666666666666664","43.3333333333333360","HOMEM"
"250750705000804","1","253","80","333","75.975975975975970","24.0240240240240230","HOMEM"
"250750705000805","1","130","86","216","60.185185185185180","39.8148148148148200","HOMEM"
"250750705000806","1","140","85","225","62.222222222222220","37.7777777777777800","HOMEM"
"250750705000807","1","198","126","324","61.111111111111114","38.8888888888888860","HOMEM"
"250750705000808","1","98","97","195","50.256410256410255","49.7435897435897450","HOMEM"
"250750705000809","1","124","82","206","60.194174757281550","39.8058252427184500","HOMEM"
"250750705000810","1","144","104","248","58.064516129032256","41.9354838709677440","HOMEM"
"250750705000811","1","136","59","195","69.743589743589740","30.2564102564102550","HOMEM"
"250750705000812","1","165","96","261","63.218390804597700","36.7816091954023000","HOMEM"
"250750705000813","1","78","22","100","78.000000000000000","22.0000000000000000","HOMEM"
"250750705000814","1","143","87","230","62.173913043478260","37.8260869565217400","HOMEM"
"250750705000815","1","101","41","142","71.126760563380290","28.8732394366197200","HOMEM"
"250750705000816","1","159","82","241","65.975103734439830","34.0248962655601660","HOMEM"
"250750705000817","1","93","104","197","47.208121827411170","52.7918781725888300","MULHER"
"250750705000818","1","70","75","145","48.275862068965516","51.7241379310344840","MULHER"
"250750705000819","1","71","58","129","55.038759689922480","44.9612403100775200","HOMEM"
"250750705000820","1","87","123","210","41.428571428571430","58.5714285714285700","MULHER"
"250750705000821","1","136","126","262","51.908396946564885","48.0916030534351150","HOMEM"
"250750705000822","1","110","53","163","67.484662576687110","32.5153374233128860","HOMEM"
"250750705000823","1","145","111","256","56.640625000000000","43.3593750000000000","HOMEM"
"250750705000824","1","79","34","113","69.911504424778760","30.0884955752212380","HOMEM"
"250750705000825","1","83","39","122","68.032786885245900","31.9672131147541000","HOMEM"
"250750705000826","1","100","72","172","58.139534883720930","41.8604651162790700","HOMEM"
"250750705000827","1","103","73","176","58.522727272727270","41.4772727272727300","HOMEM"
"250750705000828","1","155","100","255","60.784313725490190","39.2156862745098100","HOMEM"
"250750705000829","1","119","87","206","57.766990291262130","42.2330097087378700","HOMEM"
"250750705000830","1","136","117","253","53.754940711462450","46.2450592885375500","HOMEM"
"250750705000831","1","157","88","245","64.081632653061220","35.9183673469387700","HOMEM"
"250750705000832","1","82","79","161","50.931677018633540","49.0683229813664600","HOMEM"
"250750705000833","1","102","49","151","67.549668874172180","32.4503311258278160","HOMEM"
"250750705000834","1","127","61","188","67.553191489361710","32.4468085106383000","HOMEM"
"250750705000835","1","88","59","147","59.863945578231295","40.1360544217687050","HOMEM"
"250750705000836","1","107","75","182","58.791208791208790","41.2087912087912100","HOMEM"
"250750705000837","1","172","47","219","78.538812785388130","21.4611872146118720","HOMEM"
"250750705000838","1","142","43","185","76.756756756756760","23.2432432432432420","HOMEM"
"250750705000839","1","226","48","274","82.481751824817520","17.5182481751824800","HOMEM"
"250750705000840","1","190","58","248","76.612903225806450","23.3870967741935480","HOMEM"
"250750705000841","1","8","1","9","88.888888888888890","11.1111111111111100","HOMEM"
"250750705000842","1","146","56","202","72.277227722772280","27.7227722772277230","HOMEM"
"250750705000843","1","109","112","221","49.321266968325794","50.6787330316742060","MULHER"
"250750705000844","1","103","95","198","52.020202020202020","47.9797979797979800","HOMEM"
"250750705000845","1","120","63","183","65.573770491803270","34.4262295081967200","HOMEM"
"250750705000846","1","96","69","165","58.181818181818180","41.8181818181818200","HOMEM"
"250750705000847","1","190","132","322","59.006211180124225","40.9937888198757750","HOMEM"
"250750705000848","1","164","106","270","60.740740740740740","39.2592592592592600","HOMEM"
"250750705000849","1","75","118","193","38.860103626943010","61.1398963730569900","MULHER"
"250750705000850","1","85","63","148","57.432432432432435","42.5675675675675650","HOMEM"
"250750705000851","1","89","73","162","54.938271604938270","45.0617283950617300","HOMEM"
"250750705000852","1","160","39","199","80.402010050251260","19.5979899497487440","HOMEM"
"250750705000853","1","129","68","197","65.482233502538070","34.5177664974619300","HOMEM"
"250750705000854","1","78","69","147","53.061224489795920","46.9387755102040800","HOMEM"
"250750705000855","1","141","73","214","65.887850467289720","34.1121495327102800","HOMEM"
"250750705000856","1","89","128","217","41.013824884792626","58.9861751152073740","MULHER"
"250750705000857","1","135","72","207","65.217391304347830","34.7826086956521700","HOMEM"
"250750705000858","1","106","76","182","58.241758241758240","41.7582417582417600","HOMEM"
"250750705000859","1","232","84","316","73.417721518987340","26.5822784810126580","HOMEM"
"250750705000860","1","94","179","273","34.432234432234430","65.5677655677655600","MULHER"
"250750705000861","1","143","174","317","45.110410094637224","54.8895899053627760","MULHER"
"250750705000862","1","150","60","210","71.428571428571430","28.5714285714285730","HOMEM"
"250750705000863","1","133","118","251","52.988047808764940","47.0119521912350600","HOMEM"
"250750705000864","1","94","135","229","41.048034934497814","58.9519650655021860","MULHER"
"250750705000865","1","180","112","292","61.643835616438360","38.3561643835616400","HOMEM"
"250750705000866","1","108","180","288","37.500000000000000","62.5000000000000000","MULHER"
"250750705000867","1","92","39","131","70.229007633587780","29.7709923664122120","HOMEM"
"250750705000868","1","178","89","267","66.666666666666670","33.3333333333333360","HOMEM"
"250750705000869","1","104","135","239","43.514644351464430","56.4853556485355700","MULHER"
"250750705000870","1","112","118","230","48.695652173913050","51.3043478260869500","MULHER"
"250750705000871","1","148","125","273","54.212454212454210","45.7875457875457900","HOMEM"
"250750705000872","1","178","114","292","60.958904109589040","39.0410958904109600","HOMEM"
"250750705000873","1","190","124","314","60.509554140127390","39.4904458598726100","HOMEM"
"250750705000874","1","158","102","260","60.769230769230770","39.2307692307692300","HOMEM"
"250750705000875","1","109","99","208","52.403846153846150","47.5961538461538500","HOMEM"
"250750705000876","1","99","91","190","52.105263157894740","47.8947368421052600","HOMEM"
"250750705000877","1","97","83","180","53.888888888888886","46.1111111111111140","HOMEM"
"250750705000878","1","194","72","266","72.932330827067670","27.0676691729323300","HOMEM"
"250750705000879","1","110","69","179","61.452513966480446","38.5474860335195540","HOMEM"
"250750705000880","1","190","148","338","56.213017751479290","43.7869822485207100","HOMEM"
"250750705000881","1","172","90","262","65.648854961832060","34.3511450381679400","HOMEM"
"250750705000882","1","103","56","159","64.779874213836480","35.2201257861635200","HOMEM"
"250750705000883","1","119","167","286","41.608391608391610","58.3916083916083900","MULHER"
"250750705000884","1","155","50","205","75.609756097560980","24.3902439024390250","HOMEM"
"250750705000885","1","149","96","245","60.816326530612244","39.1836734693877560","HOMEM"
"250750705000886","1","67","109","176","38.068181818181820","61.9318181818181800","MULHER"
"250750705000887","1","121","56","177","68.361581920903960","31.6384180790960450","HOMEM"
"250750705000888","1","97","65","162","59.876543209876544","40.1234567901234560","HOMEM"
"250750705000889","1","138","94","232","59.482758620689660","40.5172413793103400","HOMEM"
"250750705000890","1","91","76","167","54.491017964071860","45.5089820359281400","HOMEM"
"250750705000891","1","57","52","109","52.293577981651374","47.7064220183486260","HOMEM"
"250750705000892","1","72","119","191","37.696335078534034","62.3036649214659660","MULHER"
"250750705000893","1","129","92","221","58.371040723981900","41.6289592760181000","HOMEM"
"250750705000894","1","126","99","225","56.000000000000000","44.0000000000000000","HOMEM"
"250750705000895","1","68","178","246","27.642276422764226","72.3577235772357700","MULHER"
"250750705000896","1","126","99","225","56.000000000000000","44.0000000000000000","HOMEM"
"250750705000897","1","180","75","255","70.588235294117650","29.4117647058823500","HOMEM"
"250750705000898","1","246","89","335","73.432835820895520","26.5671641791044770","HOMEM"
"250750705000899","1","114","73","187","60.962566844919785","39.0374331550802150","HOMEM"
"250750705000900","1","170","60","230","73.913043478260870","26.0869565217391300","HOMEM"
"250750705000901","1","135","65","200","67.500000000000000","32.5000000000000000","HOMEM"
"250750705000902","1","140","50","190","73.684210526315800","26.3157894736842100","HOMEM"
"250750705000903","1","152","109","261","58.237547892720310","41.7624521072796900","HOMEM"
"250750705000904","1","9","9","18","50.000000000000000","50.0000000000000000","IGUAL"
"250750705000905","1","131","98","229","57.205240174672490","42.7947598253275100","HOMEM"
"250750705000906","1","176","157","333","52.852852852852855","47.1471471471471450","HOMEM"
"250750705000907","1","86","87","173","49.710982658959540","50.2890173410404600","MULHER"
"250750705000908","1","127","100","227","55.947136563876654","44.0528634361233460","HOMEM"
"250750705000909","1","73","73","146","50.000000000000000","50.0000000000000000","IGUAL"
"250750705000910","4","20","1","21","95.238095238095240","4.7619047619047620","HOMEM"
"250750705000911","1","397","163","560","70.892857142857140","29.1071428571428580","HOMEM"
"250750705000912","1","102","25","127","80.314960629921260","19.6850393700787400","HOMEM"
"250750705000913","1","86","59","145","59.310344827586206","40.6896551724137940","HOMEM"
"250750705000914","1","104","49","153","67.973856209150330","32.0261437908496700","HOMEM"
"250750705000915","1","134","89","223","60.089686098654710","39.9103139013452900","HOMEM"
"250750705000916","1","156","86","242","64.462809917355370","35.5371900826446300","HOMEM"
"250750705000917","1","37","43","80","46.250000000000000","53.7500000000000000","MULHER"
"250750705000918","1","58","123","181","32.044198895027630","67.9558011049723800","MULHER"
"250750705000919","1","122","110","232","52.586206896551720","47.4137931034482800","HOMEM"
"250750705000920","1","176","70","246","71.544715447154470","28.4552845528455300","HOMEM"
"250750705000921","1","221","165","386","57.253886010362690","42.7461139896373100","HOMEM"
"250750705000922","1","73","116","189","38.624338624338630","61.3756613756613700","MULHER"
"250750705000923","1","254","84","338","75.147928994082850","24.8520710059171600","HOMEM"
"250750705000924","1","262","88","350","74.857142857142860","25.1428571428571420","HOMEM"
"250750705000925","1","41","80","121","33.884297520661160","66.1157024793388400","MULHER"
"250750705000927","1","53","147","200","26.500000000000000","73.5000000000000000","MULHER"
"250750705000928","1","222","117","339","65.486725663716810","34.5132743362831900","HOMEM"
"250750705000929","1","181","98","279","64.874551971326170","35.1254480286738400","HOMEM"
"250750705000930","1","171","56","227","75.330396475770930","24.6696035242290750","HOMEM"
"250750705000931","1","185","69","254","72.834645669291330","27.1653543307086630","HOMEM"
"250750705000932","1","189","74","263","71.863117870722430","28.1368821292775660","HOMEM"
"250750705000933","1","90","133","223","40.358744394618830","59.6412556053811700","MULHER"
"250750705000934","1","176","99","275","64.000000000000000","36.0000000000000000","HOMEM"
"250750705000935","1","169","109","278","60.791366906474820","39.2086330935251800","HOMEM"
"250750705000936","1","136","54","190","71.578947368421050","28.4210526315789500","HOMEM"
"250750705000937","1","76","49","125","60.800000000000000","39.2000000000000000","HOMEM"
"250750705000938","1","103","79","182","56.593406593406590","43.4065934065934100","HOMEM"
"250750705000939","1","130","102","232","56.034482758620690","43.9655172413793100","HOMEM"
"250750705000940","1","132","150","282","46.808510638297875","53.1914893617021250","MULHER"
"250750705000941","1","192","112","304","63.157894736842100","36.8421052631579000","HOMEM"
"250750705000942","1","134","97","231","58.008658008658010","41.9913419913419900","HOMEM"
"250750705000943","1","100","96","196","51.020408163265310","48.9795918367346900","HOMEM"
"250750705000944","1","147","162","309","47.572815533980580","52.4271844660194200","MULHER"
"250750705000945","1","245","63","308","79.545454545454550","20.4545454545454530","HOMEM"
"250750705000946","1","98","88","186","52.688172043010750","47.3118279569892500","HOMEM"
"250750705000947","1","127","73","200","63.500000000000000","36.5000000000000000","HOMEM"
"250750705000948","1","310","119","429","72.261072261072260","27.7389277389277400","HOMEM"
"250750705000949","1","188","90","278","67.625899280575540","32.3741007194244600","HOMEM"
"250750705000951","8","0","0","0",NULL,NULL,NULL
"250750705000952","1","29","5","34","85.294117647058830","14.7058823529411760","HOMEM"
"250750705000953","1","189","114","303","62.376237623762380","37.6237623762376200","HOMEM"
"250750705000954","1","47","26","73","64.383561643835620","35.6164383561643800","HOMEM"
"250750705000955","1","37","60","97","38.144329896907216","61.8556701030927840","MULHER"
"250750705000956","1","6","7","13","46.153846153846150","53.8461538461538500","MULHER"
"250750705000957","1","0","0","0",NULL,NULL,NULL
"250750705000958","1","0","0","0",NULL,NULL,NULL
"250750705000959","1","46","18","64","71.875000000000000","28.1250000000000000","HOMEM"
"250750705000960","1","43","29","72","59.722222222222220","40.2777777777777800","HOMEM"
"250750705000961","1","120","75","195","61.538461538461540","38.4615384615384600","HOMEM"
"250750705000962","1","45","146","191","23.560209424083770","76.4397905759162300","MULHER"
"250750705000963","1","102","62","164","62.195121951219510","37.8048780487804900","HOMEM"
"250760605000001","1","204","86","290","70.344827586206890","29.6551724137931030","HOMEM"
"250760605000002","1","115","125","240","47.916666666666664","52.0833333333333360","MULHER"
"250760605000003","1","86","81","167","51.497005988023950","48.5029940119760500","HOMEM"
"250760605000004","1","113","82","195","57.948717948717950","42.0512820512820500","HOMEM"
"250760605000005","1","38","188","226","16.814159292035400","83.1858407079646000","MULHER"
"250760605000006","8","94","67","161","58.385093167701860","41.6149068322981400","HOMEM"
"250760605000007","8","119","65","184","64.673913043478270","35.3260869565217400","HOMEM"
"250760605000008","8","64","26","90","71.111111111111110","28.8888888888888900","HOMEM"
"250760605000010","1","89","58","147","60.544217687074830","39.4557823129251700","HOMEM"
"250760605000011","1","180","102","282","63.829787234042556","36.1702127659574440","HOMEM"
"250760605000012","1","35","170","205","17.073170731707318","82.9268292682926800","MULHER"
"250770505000001","1","83","139","222","37.387387387387385","62.6126126126126150","MULHER"
"250770505000002","1","183","106","289","63.321799307958480","36.6782006920415200","HOMEM"
"250770505000003","1","110","119","229","48.034934497816590","51.9650655021834100","MULHER"
"250770505000004","1","138","59","197","70.050761421319790","29.9492385786802020","HOMEM"
"250770505000005","1","78","164","242","32.231404958677686","67.7685950413223100","MULHER"
"250770505000006","1","190","93","283","67.137809187279150","32.8621908127208500","HOMEM"
"250770505000007","1","81","101","182","44.505494505494504","55.4945054945054960","MULHER"
"250770505000008","1","137","105","242","56.611570247933884","43.3884297520661160","HOMEM"
"250770505000009","8","299","92","391","76.470588235294120","23.5294117647058840","HOMEM"
"250770505000010","8","156","33","189","82.539682539682540","17.4603174603174600","HOMEM"
"250770505000011","8","51","81","132","38.636363636363630","61.3636363636363700","MULHER"
"250770505000012","8","200","60","260","76.923076923076920","23.0769230769230770","HOMEM"
"250770505000013","8","275","70","345","79.710144927536230","20.2898550724637700","HOMEM"
"250770505000014","8","111","34","145","76.551724137931030","23.4482758620689640","HOMEM"
"250770505000015","8","129","20","149","86.577181208053690","13.4228187919463090","HOMEM"
"250770505000016","5","27","19","46","58.695652173913050","41.3043478260869500","HOMEM"
"250770505000017","8","189","40","229","82.532751091703060","17.4672489082969450","HOMEM"
"250770505000018","1","59","24","83","71.084337349397590","28.9156626506024100","HOMEM"
"250770505000019","1","114","113","227","50.220264317180614","49.7797356828193860","HOMEM"
"250770505000020","1","107","119","226","47.345132743362830","52.6548672566371700","MULHER"
"250770505000021","1","102","71","173","58.959537572254334","41.0404624277456660","HOMEM"
"250780405000001","1","152","69","221","68.778280542986420","31.2217194570135740","HOMEM"
"250780405000002","1","210","112","322","65.217391304347830","34.7826086956521700","HOMEM"
"250780405000003","1","89","83","172","51.744186046511630","48.2558139534883700","HOMEM"
"250780405000004","8","252","29","281","89.679715302491100","10.3202846975088960","HOMEM"
"250780405000005","8","77","11","88","87.500000000000000","12.5000000000000000","HOMEM"
"250780405000006","8","47","44","91","51.648351648351650","48.3516483516483500","HOMEM"
"250780405000007","8","32","6","38","84.210526315789480","15.7894736842105260","HOMEM"
"250780405000008","1","136","36","172","79.069767441860460","20.9302325581395370","HOMEM"
"250780405000009","1","108","66","174","62.068965517241380","37.9310344827586200","HOMEM"
"250780405000010","1","155","64","219","70.776255707762560","29.2237442922374400","HOMEM"
"250780405000011","5","83","34","117","70.940170940170940","29.0598290598290600","HOMEM"
"250790305000001","1","150","66","216","69.444444444444440","30.5555555555555570","HOMEM"
"250790305000002","1","48","211","259","18.532818532818530","81.4671814671814600","MULHER"
"250790305000003","1","103","166","269","38.289962825278810","61.7100371747211900","MULHER"
"250790305000004","1","193","88","281","68.683274021352320","31.3167259786476850","HOMEM"
"250790305000005","1","209","157","366","57.103825136612020","42.8961748633879800","HOMEM"
"250790305000006","1","211","131","342","61.695906432748540","38.3040935672514600","HOMEM"
"250790305000007","1","119","88","207","57.487922705314010","42.5120772946859900","HOMEM"
"250790305000008","1","155","84","239","64.853556485355650","35.1464435146443500","HOMEM"
"250790305000009","1","248","132","380","65.263157894736840","34.7368421052631600","HOMEM"
"250790305000010","8","99","24","123","80.487804878048780","19.5121951219512200","HOMEM"
"250790305000011","8","44","10","54","81.481481481481480","18.5185185185185200","HOMEM"
"250790305000012","1","125","43","168","74.404761904761900","25.5952380952380950","HOMEM"
"250800005000001","1","221","59","280","78.928571428571430","21.0714285714285730","HOMEM"
"250800005000002","1","193","94","287","67.247386759581890","32.7526132404181200","HOMEM"
"250800005000003","1","109","79","188","57.978723404255320","42.0212765957446800","HOMEM"
"250800005000004","1","71","79","150","47.333333333333336","52.6666666666666640","MULHER"
"250800005000005","8","137","29","166","82.530120481927710","17.4698795180722900","HOMEM"
"250800005000006","8","58","73","131","44.274809160305345","55.7251908396946550","MULHER"
"250800005000007","8","54","67","121","44.628099173553720","55.3719008264462800","MULHER"
"250800005000008","8","91","15","106","85.849056603773590","14.1509433962264150","HOMEM"
"250800005000009","8","64","112","176","36.363636363636370","63.6363636363636300","MULHER"
"250800005000010","8","73","17","90","81.111111111111110","18.8888888888888900","HOMEM"
"250800005000011","8","50","12","62","80.645161290322580","19.3548387096774200","HOMEM"
"250800005000012","8","29","16","45","64.444444444444440","35.5555555555555600","HOMEM"
"250800005000013","8","60","125","185","32.432432432432435","67.5675675675675600","MULHER"
"250800005000014","5","119","27","146","81.506849315068500","18.4931506849315070","HOMEM"
"250800005000015","1","127","46","173","73.410404624277460","26.5895953757225420","HOMEM"
"250800005000016","1","137","50","187","73.262032085561500","26.7379679144385030","HOMEM"
"250800005000017","5","115","47","162","70.987654320987660","29.0123456790123450","HOMEM"
"250800005000018","5","30","30","60","50.000000000000000","50.0000000000000000","IGUAL"
"250810905000001","1","201","66","267","75.280898876404490","24.7191011235955070","HOMEM"
"250810905000002","1","155","96","251","61.752988047808760","38.2470119521912400","HOMEM"
"250810905000003","8","129","94","223","57.847533632286996","42.1524663677130040","HOMEM"
"250810905000004","8","27","6","33","81.818181818181810","18.1818181818181830","HOMEM"
"250810905000005","8","84","139","223","37.668161434977580","62.3318385650224200","MULHER"
"250810905000006","8","11","16","27","40.740740740740740","59.2592592592592600","MULHER"
"250810905000007","8","102","31","133","76.691729323308270","23.3082706766917300","HOMEM"
"250810905000008","1","110","48","158","69.620253164556960","30.3797468354430360","HOMEM"
"250820805000001","1","83","195","278","29.856115107913670","70.1438848920863300","MULHER"
"250820805000002","1","136","143","279","48.745519713261650","51.2544802867383500","MULHER"
"250820805000003","1","154","106","260","59.230769230769230","40.7692307692307700","HOMEM"
"250820805000004","1","137","91","228","60.087719298245620","39.9122807017543800","HOMEM"
"250820805000005","8","106","16","122","86.885245901639350","13.1147540983606560","HOMEM"
"250820805000006","8","125","40","165","75.757575757575750","24.2424242424242420","HOMEM"
"250820805000007","8","21","2","23","91.304347826086950","8.6956521739130430","HOMEM"
"250820805000008","8","82","20","102","80.392156862745100","19.6078431372549030","HOMEM"
"250820805000009","8","155","47","202","76.732673267326730","23.2673267326732700","HOMEM"
"250820805000010","5","37","29","66","56.060606060606060","43.9393939393939400","HOMEM"
"250820805000011","8","58","26","84","69.047619047619050","30.9523809523809530","HOMEM"
"250820805000012","8","23","7","30","76.666666666666670","23.3333333333333320","HOMEM"
"250820805000013","8","36","50","86","41.860465116279070","58.1395348837209300","MULHER"
"250820805000014","1","111","69","180","61.666666666666664","38.3333333333333360","HOMEM"
"250820805000015","5","47","17","64","73.437500000000000","26.5625000000000000","HOMEM"
"250830705000001","1","85","213","298","28.523489932885905","71.4765100671140900","MULHER"
"250830705000002","1","239","107","346","69.075144508670520","30.9248554913294800","HOMEM"
"250830705000003","1","191","143","334","57.185628742514970","42.8143712574850300","HOMEM"
"250830705000004","1","194","136","330","58.787878787878790","41.2121212121212100","HOMEM"
"250830705000005","1","209","118","327","63.914373088685020","36.0856269113149800","HOMEM"
"250830705000006","1","218","98","316","68.987341772151900","31.0126582278481000","HOMEM"
"250830705000007","1","134","128","262","51.145038167938930","48.8549618320610700","HOMEM"
"250830705000008","3","146","54","200","73.000000000000000","27.0000000000000000","HOMEM"
"250830705000009","8","62","68","130","47.692307692307690","52.3076923076923100","MULHER"
"250830705000010","8","91","36","127","71.653543307086610","28.3464566929133850","HOMEM"
"250830705000011","4","31","45","76","40.789473684210530","59.2105263157894700","MULHER"
"250830705000012","8","176","35","211","83.412322274881520","16.5876777251184820","HOMEM"
"250830705000013","8","241","77","318","75.786163522012570","24.2138364779874200","HOMEM"
"250830705000014","4","23","110","133","17.293233082706767","82.7067669172932400","MULHER"
"250830705000015","8","186","122","308","60.389610389610390","39.6103896103896100","HOMEM"
"250830705000016","4","144","73","217","66.359447004608300","33.6405529953917100","HOMEM"
"250830705000017","8","82","24","106","77.358490566037730","22.6415094339622630","HOMEM"
"250830705000018","8","33","17","50","66.000000000000000","34.0000000000000000","HOMEM"
"250830705000019","8","207","65","272","76.102941176470600","23.8970588235294130","HOMEM"
"250830705000020","8","71","16","87","81.609195402298850","18.3908045977011500","HOMEM"
"250830705000021","8","109","26","135","80.740740740740750","19.2592592592592600","HOMEM"
"250830705000022","4","110","51","161","68.322981366459630","31.6770186335403740","HOMEM"
"250830705000023","8","112","69","181","61.878453038674030","38.1215469613259700","HOMEM"
"250830705000024","4","121","66","187","64.705882352941170","35.2941176470588260","HOMEM"
"250830705000025","8","87","19","106","82.075471698113200","17.9245283018867900","HOMEM"
"250830705000026","8","202","58","260","77.692307692307700","22.3076923076923070","HOMEM"
"250830705000027","8","129","73","202","63.861386138613860","36.1386138613861400","HOMEM"
"250830705000028","8","239","77","316","75.632911392405060","24.3670886075949370","HOMEM"
"250830705000029","8","119","42","161","73.913043478260870","26.0869565217391300","HOMEM"
"250830705000030","4","194","83","277","70.036101083032490","29.9638989169675100","HOMEM"
"250830705000031","8","18","5","23","78.260869565217390","21.7391304347826100","HOMEM"
"250830705000032","8","70","32","102","68.627450980392150","31.3725490196078420","HOMEM"
"250830705000033","1","116","52","168","69.047619047619050","30.9523809523809530","HOMEM"
"250830705000034","1","207","77","284","72.887323943661970","27.1126760563380280","HOMEM"
"250830705000035","1","72","37","109","66.055045871559630","33.9449541284403650","HOMEM"
"250830705000036","4","51","9","60","85.000000000000000","15.0000000000000000","HOMEM"
"250840605000001","1","255","78","333","76.576576576576570","23.4234234234234220","HOMEM"
"250840605000002","8","68","23","91","74.725274725274730","25.2747252747252740","HOMEM"
"250840605000003","8","58","12","70","82.857142857142860","17.1428571428571420","HOMEM"
"250840605000004","8","24","25","49","48.979591836734690","51.0204081632653100","MULHER"
"250840605000005","8","17","11","28","60.714285714285715","39.2857142857142850","HOMEM"
"250840605000006","5","74","80","154","48.051948051948050","51.9480519480519500","MULHER"
"250850505000001","1","87","98","185","47.027027027027025","52.9729729729729750","MULHER"
"250850505000002","1","151","114","265","56.981132075471700","43.0188679245283000","HOMEM"
"250850505000003","1","185","114","299","61.872909698996660","38.1270903010033400","HOMEM"
"250850505000004","1","173","89","262","66.030534351145040","33.9694656488549640","HOMEM"
"250850505000005","8","90","44","134","67.164179104477610","32.8358208955223900","HOMEM"
"250850505000006","8","182","55","237","76.793248945147680","23.2067510548523220","HOMEM"
"250850505000007","8","318","51","369","86.178861788617880","13.8211382113821130","HOMEM"
"250850505000008","8","114","31","145","78.620689655172410","21.3793103448275870","HOMEM"
"250850505000009","1","34","113","147","23.129251700680270","76.8707482993197300","MULHER"
"250855405000001","1","131","100","231","56.709956709956710","43.2900432900432900","HOMEM"
"250855405000002","1","100","172","272","36.764705882352940","63.2352941176470600","MULHER"
"250855405000003","8","136","43","179","75.977653631284920","24.0223463687150840","HOMEM"
"250855405000004","8","78","30","108","72.222222222222230","27.7777777777777800","HOMEM"
"250855405000005","8","85","53","138","61.594202898550726","38.4057971014492740","HOMEM"
"250855405000006","5","115","61","176","65.340909090909100","34.6590909090909100","HOMEM"
"250860405000001","1","154","116","270","57.037037037037040","42.9629629629629600","HOMEM"
"250860405000002","1","152","63","215","70.697674418604650","29.3023255813953480","HOMEM"
"250860405000003","1","66","11","77","85.714285714285710","14.2857142857142860","HOMEM"
"250860405000004","1","199","98","297","67.003367003367000","32.9966329966330000","HOMEM"
"250860405000005","1","81","43","124","65.322580645161300","34.6774193548387100","HOMEM"
"250860405000006","1","101","47","148","68.243243243243240","31.7567567567567580","HOMEM"
"250860405000007","8","144","19","163","88.343558282208590","11.6564417177914110","HOMEM"
"250860405000008","8","58","71","129","44.961240310077520","55.0387596899224800","MULHER"
"250860405000009","1","127","87","214","59.345794392523366","40.6542056074766340","HOMEM"
"250860405000010","1","28","45","73","38.356164383561640","61.6438356164383600","MULHER"
"250860415000001","1","143","74","217","65.898617511520740","34.1013824884792600","HOMEM"
"250860415000002","1","169","62","231","73.160173160173160","26.8398268398268400","HOMEM"
"250860415000003","1","103","49","152","67.763157894736840","32.2368421052631600","HOMEM"
"250860415000004","1","123","72","195","63.076923076923080","36.9230769230769200","HOMEM"
"250860415000005","1","187","95","282","66.312056737588650","33.6879432624113450","HOMEM"
"250860415000006","8","77","13","90","85.555555555555560","14.4444444444444450","HOMEM"
"250860415000007","1","121","104","225","53.777777777777780","46.2222222222222200","HOMEM"
"250870305000001","1","172","127","299","57.525083612040135","42.4749163879598650","HOMEM"
"250870305000002","1","95","80","175","54.285714285714285","45.7142857142857150","HOMEM"
"250870305000003","8","55","78","133","41.353383458646620","58.6466165413533800","MULHER"
"250870305000004","5","89","81","170","52.352941176470590","47.6470588235294100","HOMEM"
"250870305000005","8","47","55","102","46.078431372549020","53.9215686274509800","MULHER"
"250870305000006","8","35","8","43","81.395348837209300","18.6046511627907000","HOMEM"
"250870305000007","8","91","46","137","66.423357664233580","33.5766423357664200","HOMEM"
"250870305000008","8","28","26","54","51.851851851851855","48.1481481481481450","HOMEM"
"250870305000009","8","39","25","64","60.937500000000000","39.0625000000000000","HOMEM"
"250880205000001","1","144","104","248","58.064516129032256","41.9354838709677440","HOMEM"
"250880205000002","1","121","191","312","38.782051282051285","61.2179487179487150","MULHER"
"250880205000003","1","84","97","181","46.408839779005525","53.5911602209944750","MULHER"
"250880205000004","1","136","74","210","64.761904761904760","35.2380952380952400","HOMEM"
"250880205000005","8","57","10","67","85.074626865671650","14.9253731343283590","HOMEM"
"250880205000006","8","100","12","112","89.285714285714290","10.7142857142857140","HOMEM"
"250880205000007","1","133","102","235","56.595744680851060","43.4042553191489400","HOMEM"
"250880205000008","1","169","106","275","61.454545454545450","38.5454545454545500","HOMEM"
"250890105000001","1","197","130","327","60.244648318042810","39.7553516819571900","HOMEM"
"250890105000002","1","185","93","278","66.546762589928050","33.4532374100719400","HOMEM"
"250890105000003","1","176","86","262","67.175572519083970","32.8244274809160300","HOMEM"
"250890105000004","1","212","93","305","69.508196721311480","30.4918032786885260","HOMEM"
"250890105000005","1","202","63","265","76.226415094339630","23.7735849056603800","HOMEM"
"250890105000006","1","133","108","241","55.186721991701250","44.8132780082987500","HOMEM"
"250890105000007","1","149","170","319","46.708463949843264","53.2915360501567360","MULHER"
"250890105000008","1","262","98","360","72.777777777777770","27.2222222222222200","HOMEM"
"250890105000009","1","221","85","306","72.222222222222230","27.7777777777777800","HOMEM"
"250890105000010","1","202","105","307","65.798045602605870","34.2019543973941400","HOMEM"
"250890105000011","1","202","86","288","70.138888888888890","29.8611111111111100","HOMEM"
"250890105000012","1","156","70","226","69.026548672566380","30.9734513274336300","HOMEM"
"250890105000013","1","213","106","319","66.771159874608140","33.2288401253918500","HOMEM"
"250890105000014","1","180","131","311","57.877813504823150","42.1221864951768500","HOMEM"
"250890105000015","1","187","102","289","64.705882352941170","35.2941176470588260","HOMEM"
"250890105000016","1","144","103","247","58.299595141700410","41.7004048582995900","HOMEM"
"250890105000017","1","125","56","181","69.060773480662990","30.9392265193370160","HOMEM"
"250890105000018","1","74","69","143","51.748251748251750","48.2517482517482500","HOMEM"
"250890105000019","1","146","127","273","53.479853479853480","46.5201465201465200","HOMEM"
"250890105000020","1","164","63","227","72.246696035242300","27.7533039647577100","HOMEM"
"250890105000021","1","130","101","231","56.277056277056275","43.7229437229437250","HOMEM"
"250890105000022","1","55","46","101","54.455445544554460","45.5445544554455400","HOMEM"
"250890105000023","1","193","85","278","69.424460431654680","30.5755395683453240","HOMEM"
"250890105000024","1","193","92","285","67.719298245614040","32.2807017543859660","HOMEM"
"250890105000025","1","199","95","294","67.687074829931970","32.3129251700680300","HOMEM"
"250890105000026","1","236","119","355","66.478873239436620","33.5211267605633840","HOMEM"
"250890105000027","1","202","72","274","73.722627737226280","26.2773722627737240","HOMEM"
"250890105000028","1","134","71","205","65.365853658536580","34.6341463414634100","HOMEM"
"250890105000029","1","147","80","227","64.757709251101320","35.2422907488986750","HOMEM"
"250890105000030","5","116","42","158","73.417721518987340","26.5822784810126580","HOMEM"
"250890105000031","8","91","19","110","82.727272727272730","17.2727272727272730","HOMEM"
"250890105000032","8","104","28","132","78.787878787878780","21.2121212121212100","HOMEM"
"250890105000033","8","159","36","195","81.538461538461530","18.4615384615384600","HOMEM"
"250890105000034","8","261","45","306","85.294117647058830","14.7058823529411760","HOMEM"
"250890105000035","8","34","58","92","36.956521739130440","63.0434782608695600","MULHER"
"250890105000036","8","4","1","5","80.000000000000000","20.0000000000000000","HOMEM"
"250890105000038","5","33","18","51","64.705882352941170","35.2941176470588260","HOMEM"
"250890105000039","5","56","46","102","54.901960784313720","45.0980392156862800","HOMEM"
"250890105000040","1","130","74","204","63.725490196078430","36.2745098039215700","HOMEM"
"250890105000041","1","208","89","297","70.033670033670030","29.9663299663299650","HOMEM"
"250890105000042","1","145","65","210","69.047619047619050","30.9523809523809530","HOMEM"
"250890105000043","1","100","92","192","52.083333333333336","47.9166666666666640","HOMEM"
"250890105000044","1","121","90","211","57.345971563981045","42.6540284360189550","HOMEM"
"250890105000045","1","151","102","253","59.683794466403164","40.3162055335968360","HOMEM"
"250890105000046","8","86","27","113","76.106194690265480","23.8938053097345140","HOMEM"
"250890105000047","7","47","11","58","81.034482758620680","18.9655172413793100","HOMEM"
"250890105000048","4","76","27","103","73.786407766990300","26.2135922330097100","HOMEM"
"250890125000001","1","146","47","193","75.647668393782380","24.3523316062176180","HOMEM"
"250890125000002","8","45","7","52","86.538461538461530","13.4615384615384620","HOMEM"
"250890125000003","8","55","84","139","39.568345323741006","60.4316546762589940","MULHER"
"250890125000004","8","52","13","65","80.000000000000000","20.0000000000000000","HOMEM"
"250890125000005","5","172","84","256","67.187500000000000","32.8125000000000000","HOMEM"
"250890125000006","1","163","45","208","78.365384615384610","21.6346153846153830","HOMEM"
"250890125000007","8","90","40","130","69.230769230769230","30.7692307692307700","HOMEM"
"250900805000001","1","110","65","175","62.857142857142854","37.1428571428571460","HOMEM"
"250900805000002","1","34","117","151","22.516556291390728","77.4834437086092700","MULHER"
"250900805000003","1","91","78","169","53.846153846153850","46.1538461538461500","HOMEM"
"250900805000004","1","17","19","36","47.222222222222220","52.7777777777777800","MULHER"
"250900805000005","8","92","11","103","89.320388349514560","10.6796116504854370","HOMEM"
"250900805000006","8","79","12","91","86.813186813186820","13.1868131868131860","HOMEM"
"250900805000007","8","101","48","149","67.785234899328860","32.2147651006711440","HOMEM"
"250900805000008","8","23","5","28","82.142857142857140","17.8571428571428580","HOMEM"
"250900805000009","8","21","25","46","45.652173913043480","54.3478260869565200","MULHER"
"250900805000010","8","63","93","156","40.384615384615390","59.6153846153846100","MULHER"
"250900805000011","8","73","16","89","82.022471910112360","17.9775280898876400","HOMEM"
"250900805000012","1","175","62","237","73.839662447257380","26.1603375527426150","HOMEM"
"250900805000013","1","167","84","251","66.533864541832670","33.4661354581673300","HOMEM"
"250900805000014","1","65","66","131","49.618320610687020","50.3816793893129800","MULHER"
"250900805000015","1","57","163","220","25.909090909090910","74.0909090909091000","MULHER"
"250900805000016","1","182","111","293","62.116040955631400","37.8839590443686000","HOMEM"
"250900805000017","8","87","14","101","86.138613861386130","13.8613861386138610","HOMEM"
"250900805000018","8","95","42","137","69.343065693430660","30.6569343065693440","HOMEM"
"250900810000001","1","65","18","83","78.313253012048200","21.6867469879518070","HOMEM"
"250900810000002","8","74","70","144","51.388888888888886","48.6111111111111140","HOMEM"
"250900810000003","8","104","35","139","74.820143884892090","25.1798561151079130","HOMEM"
"250905705000001","1","200","110","310","64.516129032258060","35.4838709677419360","HOMEM"
"250905705000002","1","172","97","269","63.940520446096656","36.0594795539033440","HOMEM"
"250905705000003","8","209","48","257","81.322957198443580","18.6770428015564200","HOMEM"
"250905705000004","8","11","4","15","73.333333333333330","26.6666666666666680","HOMEM"
"250905705000005","5","69","27","96","71.875000000000000","28.1250000000000000","HOMEM"
"250905705000006","8","142","39","181","78.453038674033150","21.5469613259668500","HOMEM"
"250905705000007","5","56","64","120","46.666666666666664","53.3333333333333360","MULHER"
"250905705000008","5","44","17","61","72.131147540983600","27.8688524590163950","HOMEM"
"250905705000009","5","34","19","53","64.150943396226410","35.8490566037735800","HOMEM"
"250905710000001","1","104","67","171","60.818713450292400","39.1812865497076000","HOMEM"
"250905710000002","8","88","45","133","66.165413533834580","33.8345864661654100","HOMEM"
"250905710000003","5","197","103","300","65.666666666666670","34.3333333333333360","HOMEM"
"250905710000004","1","50","24","74","67.567567567567560","32.4324324324324350","HOMEM"
"250910705000001","1","147","108","255","57.647058823529410","42.3529411764705900","HOMEM"
"250910705000002","1","124","133","257","48.249027237354085","51.7509727626459150","MULHER"
"250910705000003","1","138","120","258","53.488372093023260","46.5116279069767400","HOMEM"
"250910705000004","1","149","112","261","57.088122605363985","42.9118773946360150","HOMEM"
"250910705000005","1","107","98","205","52.195121951219510","47.8048780487804900","HOMEM"
"250910705000006","1","137","90","227","60.352422907488986","39.6475770925110140","HOMEM"
"250910705000007","1","109","69","178","61.235955056179776","38.7640449438202240","HOMEM"
"250910705000008","1","121","80","201","60.199004975124380","39.8009950248756200","HOMEM"
"250910705000009","1","233","115","348","66.954022988505740","33.0459770114942500","HOMEM"
"250910705000010","1","82","55","137","59.854014598540150","40.1459854014598500","HOMEM"
"250910705000011","1","119","119","238","50.000000000000000","50.0000000000000000","IGUAL"
"250910705000012","1","187","119","306","61.111111111111114","38.8888888888888860","HOMEM"
"250910705000013","1","59","178","237","24.894514767932490","75.1054852320675100","MULHER"
"250910705000014","1","129","87","216","59.722222222222220","40.2777777777777800","HOMEM"
"250910705000015","1","122","265","387","31.524547803617573","68.4754521963824300","MULHER"
"250910705000016","1","86","73","159","54.088050314465406","45.9119496855345940","HOMEM"
"250910705000017","1","134","131","265","50.566037735849060","49.4339622641509400","HOMEM"
"250910705000018","1","86","99","185","46.486486486486484","53.5135135135135160","MULHER"
"250910705000019","1","112","108","220","50.909090909090910","49.0909090909090900","HOMEM"
"250910705000020","8","218","58","276","78.985507246376810","21.0144927536231880","HOMEM"
"250910705000021","8","89","18","107","83.177570093457940","16.8224299065420550","HOMEM"
"250910705000022","8","22","4","26","84.615384615384610","15.3846153846153850","HOMEM"
"250910705000023","8","169","58","227","74.449339207048450","25.5506607929515430","HOMEM"
"250910705000024","5","24","6","30","80.000000000000000","20.0000000000000000","HOMEM"
"250910705000025","8","5","1","6","83.333333333333330","16.6666666666666680","HOMEM"
"250910705000026","1","35","106","141","24.822695035460992","75.1773049645390000","MULHER"
"250910705000027","1","88","85","173","50.867052023121390","49.1329479768786100","HOMEM"
"250910705000028","1","156","114","270","57.777777777777780","42.2222222222222200","HOMEM"
"250910705000029","1","88","79","167","52.694610778443110","47.3053892215568900","HOMEM"
"250910705000030","8","128","34","162","79.012345679012340","20.9876543209876550","HOMEM"
"250910705000031","8","153","44","197","77.664974619289340","22.3350253807106600","HOMEM"
"250915605000001","1","194","81","275","70.545454545454550","29.4545454545454530","HOMEM"
"250915605000002","1","246","130","376","65.425531914893610","34.5744680851063800","HOMEM"
"250915605000003","1","232","100","332","69.879518072289160","30.1204819277108450","HOMEM"
"250915605000004","1","140","102","242","57.851239669421490","42.1487603305785100","HOMEM"
"250915605000005","8","118","17","135","87.407407407407400","12.5925925925925930","HOMEM"
"250915605000006","7","59","9","68","86.764705882352940","13.2352941176470580","HOMEM"
"250915605000007","1","247","79","326","75.766871165644180","24.2331288343558280","HOMEM"
"250920605000001","1","84","116","200","42.000000000000000","58.0000000000000000","MULHER"
"250920605000002","1","190","121","311","61.093247588424440","38.9067524115755600","HOMEM"
"250920605000003","1","113","71","184","61.413043478260870","38.5869565217391300","HOMEM"
"250920605000004","1","151","61","212","71.226415094339630","28.7735849056603800","HOMEM"
"250920605000005","8","193","55","248","77.822580645161300","22.1774193548387080","HOMEM"
"250920605000006","8","73","44","117","62.393162393162390","37.6068376068376100","HOMEM"
"250920605000007","8","105","29","134","78.358208955223890","21.6417910447761200","HOMEM"
"250920605000008","8","200","75","275","72.727272727272730","27.2727272727272730","HOMEM"
"250920605000009","8","91","89","180","50.555555555555560","49.4444444444444400","HOMEM"
"250920605000010","8","92","44","136","67.647058823529400","32.3529411764705900","HOMEM"
"250920605000011","8","19","27","46","41.304347826086950","58.6956521739130500","MULHER"
"250920605000012","8","91","16","107","85.046728971962620","14.9532710280373830","HOMEM"
"250920605000013","8","125","68","193","64.766839378238340","35.2331606217616550","HOMEM"
"250920605000014","8","32","21","53","60.377358490566040","39.6226415094339600","HOMEM"
"250920605000015","8","118","28","146","80.821917808219180","19.1780821917808200","HOMEM"
"250920605000016","4","130","33","163","79.754601226993870","20.2453987730061340","HOMEM"
"250920605000017","1","93","34","127","73.228346456692920","26.7716535433070850","HOMEM"
"250920605000018","1","39","122","161","24.223602484472050","75.7763975155279500","MULHER"
"250920605000019","1","63","171","234","26.923076923076923","73.0769230769230800","MULHER"
"250920605000020","4","48","24","72","66.666666666666670","33.3333333333333360","HOMEM"
"250920605000021","8","64","28","92","69.565217391304340","30.4347826086956520","HOMEM"
"250920605000022","4","244","137","381","64.041994750656170","35.9580052493438340","HOMEM"
"250930505000001","1","148","79","227","65.198237885462560","34.8017621145374460","HOMEM"
"250930505000002","1","105","81","186","56.451612903225810","43.5483870967741900","HOMEM"
"250930505000003","1","196","96","292","67.123287671232870","32.8767123287671300","HOMEM"
"250930505000004","1","161","97","258","62.403100775193800","37.5968992248062000","HOMEM"
"250930505000005","8","53","11","64","82.812500000000000","17.1875000000000000","HOMEM"
"250930505000006","1","85","48","133","63.909774436090224","36.0902255639097760","HOMEM"
"250930505000007","1","97","61","158","61.392405063291136","38.6075949367088640","HOMEM"
"250930505000008","1","186","113","299","62.207357859531776","37.7926421404682240","HOMEM"
"250930505000009","8","97","32","129","75.193798449612400","24.8062015503876000","HOMEM"
"250930510000001","1","116","66","182","63.736263736263740","36.2637362637362600","HOMEM"
"250930510000002","8","12","16","28","42.857142857142854","57.1428571428571460","MULHER"
"250933905000001","1","130","56","186","69.892473118279570","30.1075268817204320","HOMEM"
"250933905000002","8","83","22","105","79.047619047619050","20.9523809523809530","HOMEM"
"250933905000003","8","116","53","169","68.639053254437870","31.3609467455621300","HOMEM"
"250933905000004","8","112","29","141","79.432624113475170","20.5673758865248200","HOMEM"
"250933905000005","8","161","37","198","81.313131313131310","18.6868686868686900","HOMEM"
"250933905000006","8","156","47","203","76.847290640394090","23.1527093596059100","HOMEM"
"250933905000007","8","103","31","134","76.865671641791040","23.1343283582089540","HOMEM"
"250937005000001","1","100","59","159","62.893081761006286","37.1069182389937140","HOMEM"
"250937005000002","8","261","37","298","87.583892617449660","12.4161073825503350","HOMEM"
"250937005000003","8","74","20","94","78.723404255319150","21.2765957446808500","HOMEM"
"250937005000004","1","134","34","168","79.761904761904760","20.2380952380952370","HOMEM"
"250939605000001","1","90","177","267","33.707865168539330","66.2921348314606700","MULHER"
"250939605000002","1","168","133","301","55.813953488372090","44.1860465116279100","HOMEM"
"250939605000003","1","126","115","241","52.282157676348550","47.7178423236514500","HOMEM"
"250939605000004","8","57","41","98","58.163265306122450","41.8367346938775500","HOMEM"
"250939605000005","8","148","77","225","65.777777777777770","34.2222222222222200","HOMEM"
"250939605000006","8","29","60","89","32.584269662921350","67.4157303370786600","MULHER"
"250939605000007","8","26","24","50","52.000000000000000","48.0000000000000000","HOMEM"
"250939605000008","8","35","8","43","81.395348837209300","18.6046511627907000","HOMEM"
"250939605000009","8","14","8","22","63.636363636363630","36.3636363636363700","HOMEM"
"250939605000010","1","142","106","248","57.258064516129030","42.7419354838709700","HOMEM"
"250939605000011","1","36","54","90","40.000000000000000","60.0000000000000000","MULHER"
"250940405000001","1","205","158","363","56.473829201101930","43.5261707988980700","HOMEM"
"250940405000002","1","161","120","281","57.295373665480426","42.7046263345195740","HOMEM"
"250940405000003","1","117","130","247","47.368421052631580","52.6315789473684200","MULHER"
"250940405000004","1","99","52","151","65.562913907284770","34.4370860927152340","HOMEM"
"250940405000005","1","66","139","205","32.195121951219510","67.8048780487805000","MULHER"
"250940405000006","8","165","78","243","67.901234567901240","32.0987654320987660","HOMEM"
"250940405000007","8","219","116","335","65.373134328358200","34.6268656716417900","HOMEM"
"250940405000008","8","153","55","208","73.557692307692300","26.4423076923076930","HOMEM"
"250940405000009","5","79","34","113","69.911504424778760","30.0884955752212380","HOMEM"
"250940405000010","8","89","28","117","76.068376068376070","23.9316239316239320","HOMEM"
"250940405000011","1","176","152","328","53.658536585365850","46.3414634146341500","HOMEM"
"250940420000001","1","89","62","151","58.940397350993380","41.0596026490066200","HOMEM"
"250940420000002","8","85","56","141","60.283687943262414","39.7163120567375860","HOMEM"
"250940420000003","8","162","77","239","67.782426778242680","32.2175732217573200","HOMEM"
"250940420000004","5","34","23","57","59.649122807017540","40.3508771929824600","HOMEM"
"250940420000005","5","19","11","30","63.333333333333336","36.6666666666666640","HOMEM"
"250940420000006","8","105","27","132","79.545454545454550","20.4545454545454530","HOMEM"
"250940420000007","8","34","88","122","27.868852459016395","72.1311475409836000","MULHER"
"250940420000008","8","71","33","104","68.269230769230770","31.7307692307692300","HOMEM"
"250940420000009","5","35","15","50","70.000000000000000","30.0000000000000000","HOMEM"
"250950305000001","1","32","87","119","26.890756302521010","73.1092436974789900","MULHER"
"250950305000002","1","93","62","155","60.000000000000000","40.0000000000000000","HOMEM"
"250950305000003","8","139","43","182","76.373626373626380","23.6263736263736280","HOMEM"
"250950305000004","8","58","22","80","72.500000000000000","27.5000000000000000","HOMEM"
"250950305000005","8","86","64","150","57.333333333333336","42.6666666666666640","HOMEM"
"250950305000006","8","75","25","100","75.000000000000000","25.0000000000000000","HOMEM"
"250950305000007","1","223","135","358","62.290502793296090","37.7094972067039100","HOMEM"
"250950305000008","1","168","133","301","55.813953488372090","44.1860465116279100","HOMEM"
"250960205000001","1","132","65","197","67.005076142131980","32.9949238578680240","HOMEM"
"250960205000002","1","186","106","292","63.698630136986300","36.3013698630137000","HOMEM"
"250960205000003","8","166","56","222","74.774774774774770","25.2252252252252270","HOMEM"
"250960205000004","8","119","20","139","85.611510791366910","14.3884892086330930","HOMEM"
"250960205000005","8","132","33","165","80.000000000000000","20.0000000000000000","HOMEM"
"250960205000006","1","66","60","126","52.380952380952380","47.6190476190476200","HOMEM"
"250960205000007","1","102","64","166","61.445783132530120","38.5542168674698800","HOMEM"
"250970105000001","1","55","141","196","28.061224489795920","71.9387755102040800","MULHER"
"250970105000002","1","126","93","219","57.534246575342465","42.4657534246575350","HOMEM"
"250970105000003","1","143","150","293","48.805460750853240","51.1945392491467600","MULHER"
"250970105000004","1","197","151","348","56.609195402298850","43.3908045977011500","HOMEM"
"250970105000005","1","189","84","273","69.230769230769230","30.7692307692307700","HOMEM"
"250970105000006","1","97","105","202","48.019801980198020","51.9801980198019800","MULHER"
"250970105000007","1","92","140","232","39.655172413793100","60.3448275862069000","MULHER"
"250970105000008","1","138","167","305","45.245901639344260","54.7540983606557400","MULHER"
"250970105000009","1","118","74","192","61.458333333333336","38.5416666666666640","HOMEM"
"250970105000010","1","115","78","193","59.585492227979270","40.4145077720207300","HOMEM"
"250970105000011","1","94","82","176","53.409090909090910","46.5909090909090900","HOMEM"
"250970105000012","1","138","100","238","57.983193277310924","42.0168067226890760","HOMEM"
"250970105000013","1","129","63","192","67.187500000000000","32.8125000000000000","HOMEM"
"250970105000014","1","143","125","268","53.358208955223880","46.6417910447761200","HOMEM"
"250970105000015","1","186","122","308","60.389610389610390","39.6103896103896100","HOMEM"
"250970105000016","1","125","50","175","71.428571428571430","28.5714285714285730","HOMEM"
"250970105000017","1","150","154","304","49.342105263157900","50.6578947368421000","MULHER"
"250970105000018","1","149","83","232","64.224137931034480","35.7758620689655160","HOMEM"
"250970105000019","1","195","126","321","60.747663551401870","39.2523364485981300","HOMEM"
"250970105000020","1","77","203","280","27.500000000000000","72.5000000000000000","MULHER"
"250970105000021","1","99","111","210","47.142857142857146","52.8571428571428540","MULHER"
"250970105000022","8","94","21","115","81.739130434782610","18.2608695652173900","HOMEM"
"250970105000023","8","22","5","27","81.481481481481480","18.5185185185185200","HOMEM"
"250970105000024","8","89","79","168","52.976190476190474","47.0238095238095260","HOMEM"
"250970105000025","8","127","36","163","77.914110429447860","22.0858895705521480","HOMEM"
"250970105000026","8","102","28","130","78.461538461538470","21.5384615384615400","HOMEM"
"250970105000027","8","160","22","182","87.912087912087910","12.0879120879120880","HOMEM"
"250970105000028","8","143","64","207","69.082125603864740","30.9178743961352640","HOMEM"
"250970105000029","8","114","115","229","49.781659388646290","50.2183406113537100","MULHER"
"250970105000030","8","52","15","67","77.611940298507460","22.3880597014925370","HOMEM"
"250970105000031","8","126","21","147","85.714285714285710","14.2857142857142860","HOMEM"
"250970105000032","8","70","31","101","69.306930693069300","30.6930693069306920","HOMEM"
"250970105000033","8","53","21","74","71.621621621621630","28.3783783783783800","HOMEM"
"250970105000034","8","45","11","56","80.357142857142860","19.6428571428571420","HOMEM"
"250970105000035","8","146","47","193","75.647668393782380","24.3523316062176180","HOMEM"
"250970105000036","8","79","27","106","74.528301886792450","25.4716981132075480","HOMEM"
"250970105000037","8","165","30","195","84.615384615384610","15.3846153846153850","HOMEM"
"250970105000038","8","83","24","107","77.570093457943930","22.4299065420560740","HOMEM"
"250970105000039","8","62","18","80","77.500000000000000","22.5000000000000000","HOMEM"
"250970105000040","8","263","65","328","80.182926829268300","19.8170731707317070","HOMEM"
"250970105000041","8","101","41","142","71.126760563380290","28.8732394366197200","HOMEM"
"250970105000042","8","241","114","355","67.887323943661970","32.1126760563380300","HOMEM"
"250970105000043","1","163","146","309","52.750809061488674","47.2491909385113260","HOMEM"
"250970105000044","1","93","88","181","51.381215469613260","48.6187845303867400","HOMEM"
"250970105000045","1","134","105","239","56.066945606694560","43.9330543933054400","HOMEM"
"250970105000046","1","77","133","210","36.666666666666664","63.3333333333333360","MULHER"
"250970105000047","1","90","107","197","45.685279187817260","54.3147208121827400","MULHER"
"250970105000048","1","173","63","236","73.305084745762710","26.6949152542372870","HOMEM"
"250970105000049","5","32","12","44","72.727272727272730","27.2727272727272730","HOMEM"
"250970105000050","5","9","6","15","60.000000000000000","40.0000000000000000","HOMEM"
"250980005000001","1","96","96","192","50.000000000000000","50.0000000000000000","IGUAL"
"250980005000002","1","59","129","188","31.382978723404257","68.6170212765957500","MULHER"
"250980005000003","1","38","163","201","18.905472636815920","81.0945273631840800","MULHER"
"250980005000004","1","110","92","202","54.455445544554460","45.5445544554455400","HOMEM"
"250980005000005","1","162","63","225","72.000000000000000","28.0000000000000000","HOMEM"
"250980005000006","1","100","110","210","47.619047619047620","52.3809523809523800","MULHER"
"250980005000007","8","111","39","150","74.000000000000000","26.0000000000000000","HOMEM"
"250980005000008","8","34","32","66","51.515151515151516","48.4848484848484840","HOMEM"
"250980005000009","8","71","20","91","78.021978021978030","21.9780219780219780","HOMEM"
"250980005000010","5","124","85","209","59.330143540669860","40.6698564593301400","HOMEM"
"250980005000011","8","174","53","227","76.651982378854630","23.3480176211453740","HOMEM"
"250980005000012","8","82","23","105","78.095238095238100","21.9047619047619050","HOMEM"
"250980005000013","8","94","35","129","72.868217054263570","27.1317829457364330","HOMEM"
"250980005000014","8","93","17","110","84.545454545454550","15.4545454545454550","HOMEM"
"250980005000015","8","132","51","183","72.131147540983600","27.8688524590163950","HOMEM"
"250980005000016","7","84","21","105","80.000000000000000","20.0000000000000000","HOMEM"
"250980005000017","1","88","65","153","57.516339869281050","42.4836601307189500","HOMEM"
"250990905000001","1","205","234","439","46.697038724373580","53.3029612756264200","MULHER"
"250990905000002","1","98","91","189","51.851851851851855","48.1481481481481450","HOMEM"
"250990905000003","1","167","107","274","60.948905109489054","39.0510948905109460","HOMEM"
"250990905000004","8","103","24","127","81.102362204724410","18.8976377952755900","HOMEM"
"250990905000005","8","144","29","173","83.236994219653180","16.7630057803468200","HOMEM"
"250990905000006","8","206","100","306","67.320261437908500","32.6797385620915000","HOMEM"
"250990905000007","8","98","22","120","81.666666666666670","18.3333333333333320","HOMEM"
"250990905000008","5","35","20","55","63.636363636363630","36.3636363636363700","HOMEM"
"250990905000009","5","24","18","42","57.142857142857146","42.8571428571428540","HOMEM"
"250990910000001","1","89","62","151","58.940397350993380","41.0596026490066200","HOMEM"
"250990910000002","8","0","0","0",NULL,NULL,NULL
"250990910000003","8","0","0","0",NULL,NULL,NULL
"250990910000004","8","271","106","377","71.883289124668440","28.1167108753315670","HOMEM"
"250990910000005","8","183","46","229","79.912663755458510","20.0873362445414860","HOMEM"
"250990910000006","8","134","45","179","74.860335195530720","25.1396648044692730","HOMEM"
"250990910000007","5","53","44","97","54.639175257731960","45.3608247422680400","HOMEM"
"251000605000001","1","112","81","193","58.031088082901555","41.9689119170984450","HOMEM"
"251000605000002","1","140","183","323","43.343653250774000","56.6563467492260000","MULHER"
"251000605000003","8","48","90","138","34.782608695652170","65.2173913043478300","MULHER"
"251000605000004","8","274","62","336","81.547619047619050","18.4523809523809530","HOMEM"
"251000605000005","8","160","18","178","89.887640449438210","10.1123595505617980","HOMEM"
"251000605000006","8","105","10","115","91.304347826086950","8.6956521739130430","HOMEM"
"251000605000007","8","105","31","136","77.205882352941170","22.7941176470588220","HOMEM"
"251000605000008","8","113","46","159","71.069182389937110","28.9308176100628920","HOMEM"
"251000605000009","1","161","72","233","69.098712446351930","30.9012875536480680","HOMEM"
"251000605000010","1","128","78","206","62.135922330097090","37.8640776699029100","HOMEM"
"251000605000011","5","29","8","37","78.378378378378370","21.6216216216216200","HOMEM"
"251000605000012","5","36","7","43","83.720930232558150","16.2790697674418600","HOMEM"
"251000605000013","8","12","1","13","92.307692307692300","7.6923076923076925","HOMEM"
"251010505000001","1","99","121","220","45.000000000000000","55.0000000000000000","MULHER"
"251010505000002","1","138","107","245","56.326530612244895","43.6734693877551050","HOMEM"
"251010505000003","1","125","72","197","63.451776649746190","36.5482233502538100","HOMEM"
"251010505000004","1","101","70","171","59.064327485380120","40.9356725146198800","HOMEM"
"251010505000005","1","113","78","191","59.162303664921470","40.8376963350785300","HOMEM"
"251010505000006","1","73","90","163","44.785276073619634","55.2147239263803660","MULHER"
"251010505000007","1","133","95","228","58.333333333333336","41.6666666666666640","HOMEM"
"251010505000008","1","128","98","226","56.637168141592920","43.3628318584070800","HOMEM"
"251010505000009","8","139","47","186","74.731182795698930","25.2688172043010760","HOMEM"
"251010505000010","8","96","24","120","80.000000000000000","20.0000000000000000","HOMEM"
"251010505000011","4","133","107","240","55.416666666666664","44.5833333333333360","HOMEM"
"251010505000012","4","121","94","215","56.279069767441860","43.7209302325581400","HOMEM"
"251010505000013","1","34","118","152","22.368421052631580","77.6315789473684200","MULHER"
"251010505000014","1","165","136","301","54.817275747508305","45.1827242524916950","HOMEM"
"251010505000015","1","113","197","310","36.451612903225810","63.5483870967741900","MULHER"
"251020405000001","1","141","67","208","67.788461538461530","32.2115384615384600","HOMEM"
"251020405000002","1","211","120","331","63.746223564954680","36.2537764350453200","HOMEM"
"251020405000003","1","72","152","224","32.142857142857146","67.8571428571428600","MULHER"
"251020405000004","8","199","77","276","72.101449275362310","27.8985507246376800","HOMEM"
"251020405000005","8","59","18","77","76.623376623376630","23.3766233766233780","HOMEM"
"251020405000006","5","111","52","163","68.098159509202460","31.9018404907975470","HOMEM"
"251020405000007","8","20","6","26","76.923076923076920","23.0769230769230770","HOMEM"
"251020405000008","8","131","38","169","77.514792899408280","22.4852071005917150","HOMEM"
"251020405000009","1","130","72","202","64.356435643564350","35.6435643564356500","HOMEM"
"251030305000001","1","142","118","260","54.615384615384610","45.3846153846153900","HOMEM"
"251030305000002","1","61","34","95","64.210526315789480","35.7894736842105300","HOMEM"
"251030305000003","8","172","55","227","75.770925110132150","24.2290748898678420","HOMEM"
"251030305000004","8","115","22","137","83.941605839416060","16.0583941605839400","HOMEM"
"251030305000005","1","93","60","153","60.784313725490190","39.2156862745098100","HOMEM"
"251030305000006","1","186","101","287","64.808362369337980","35.1916376306620200","HOMEM"
"251030305000007","8","128","23","151","84.768211920529810","15.2317880794702000","HOMEM"
"251040205000001","1","120","48","168","71.428571428571430","28.5714285714285730","HOMEM"
"251040205000002","1","113","56","169","66.863905325443780","33.1360946745562100","HOMEM"
"251040205000003","1","198","74","272","72.794117647058830","27.2058823529411780","HOMEM"
"251040205000004","8","198","34","232","85.344827586206890","14.6551724137931030","HOMEM"
"251040205000005","8","94","19","113","83.185840707964600","16.8141592920354000","HOMEM"
"251040205000006","8","62","11","73","84.931506849315070","15.0684931506849310","HOMEM"
"251040205000007","8","60","12","72","83.333333333333330","16.6666666666666680","HOMEM"
"251040205000008","1","135","54","189","71.428571428571430","28.5714285714285730","HOMEM"
"251040205000009","1","144","54","198","72.727272727272730","27.2727272727272730","HOMEM"
"251040230000001","1","64","26","90","71.111111111111110","28.8888888888888900","HOMEM"
"251040230000002","8","184","32","216","85.185185185185190","14.8148148148148150","HOMEM"
"251040230000003","8","57","9","66","86.363636363636360","13.6363636363636370","HOMEM"
"251050105000001","1","103","66","169","60.946745562130175","39.0532544378698250","HOMEM"
"251050105000002","8","40","8","48","83.333333333333330","16.6666666666666680","HOMEM"
"251050105000003","8","25","76","101","24.752475247524753","75.2475247524752400","MULHER"
"251050105000004","8","110","23","133","82.706766917293240","17.2932330827067670","HOMEM"
"251050105000005","8","184","31","215","85.581395348837200","14.4186046511627910","HOMEM"
"251050105000006","1","133","67","200","66.500000000000000","33.5000000000000000","HOMEM"
"251050105000007","1","52","141","193","26.943005181347150","73.0569948186528500","MULHER"
"251060005000001","1","153","171","324","47.222222222222220","52.7777777777777800","MULHER"
"251060005000002","1","84","67","151","55.629139072847686","44.3708609271523140","HOMEM"
"251060005000003","8","67","14","81","82.716049382716050","17.2839506172839500","HOMEM"
"251060005000004","8","161","34","195","82.564102564102570","17.4358974358974340","HOMEM"
"251060005000005","1","129","61","190","67.894736842105260","32.1052631578947400","HOMEM"
"251065905000001","1","152","79","231","65.800865800865810","34.1991341991342000","HOMEM"
"251065905000002","8","37","7","44","84.090909090909100","15.9090909090909080","HOMEM"
"251065905000003","8","80","47","127","62.992125984251970","37.0078740157480300","HOMEM"
"251070905000001","1","20","71","91","21.978021978021978","78.0219780219780300","MULHER"
"251070905000002","8","56","99","155","36.129032258064520","63.8709677419354800","MULHER"
"251070905000003","8","17","10","27","62.962962962962960","37.0370370370370400","HOMEM"
"251070905000004","8","104","61","165","63.030303030303030","36.9696969696969700","HOMEM"
"251070905000005","1","129","105","234","55.128205128205130","44.8717948717948700","HOMEM"
"251080805000001","1","72","78","150","48.000000000000000","52.0000000000000000","MULHER"
"251080805000002","1","105","71","176","59.659090909090910","40.3409090909090900","HOMEM"
"251080805000003","1","130","152","282","46.099290780141840","53.9007092198581600","MULHER"
"251080805000004","1","106","71","177","59.887005649717516","40.1129943502824840","HOMEM"
"251080805000005","1","51","53","104","49.038461538461540","50.9615384615384600","MULHER"
"251080805000006","1","78","63","141","55.319148936170215","44.6808510638297850","HOMEM"
"251080805000007","1","128","105","233","54.935622317596570","45.0643776824034300","HOMEM"
"251080805000008","1","127","108","235","54.042553191489360","45.9574468085106400","HOMEM"
"251080805000009","1","108","98","206","52.427184466019420","47.5728155339805800","HOMEM"
"251080805000010","1","144","113","257","56.031128404669260","43.9688715953307400","HOMEM"
"251080805000011","1","180","129","309","58.252427184466020","41.7475728155339800","HOMEM"
"251080805000012","1","130","117","247","52.631578947368420","47.3684210526315800","HOMEM"
"251080805000013","1","132","144","276","47.826086956521740","52.1739130434782600","MULHER"
"251080805000014","1","67","200","267","25.093632958801496","74.9063670411985100","MULHER"
"251080805000015","1","141","88","229","61.572052401746724","38.4279475982532760","HOMEM"
"251080805000016","1","161","147","308","52.272727272727270","47.7272727272727300","HOMEM"
"251080805000017","1","64","168","232","27.586206896551722","72.4137931034482700","MULHER"
"251080805000018","1","127","89","216","58.796296296296300","41.2037037037037000","HOMEM"
"251080805000019","1","47","171","218","21.559633027522935","78.4403669724770700","MULHER"
"251080805000020","1","139","101","240","57.916666666666664","42.0833333333333360","HOMEM"
"251080805000021","1","174","139","313","55.591054313099040","44.4089456869009600","HOMEM"
"251080805000022","1","149","167","316","47.151898734177216","52.8481012658227840","MULHER"
"251080805000023","1","129","79","208","62.019230769230770","37.9807692307692300","HOMEM"
"251080805000024","1","184","94","278","66.187050359712230","33.8129496402877700","HOMEM"
"251080805000025","1","105","236","341","30.791788856304986","69.2082111436950100","MULHER"
"251080805000026","1","110","80","190","57.894736842105260","42.1052631578947400","HOMEM"
"251080805000027","1","73","61","134","54.477611940298510","45.5223880597014900","HOMEM"
"251080805000028","1","40","122","162","24.691358024691358","75.3086419753086500","MULHER"
"251080805000029","1","123","96","219","56.164383561643840","43.8356164383561600","HOMEM"
"251080805000030","1","127","165","292","43.493150684931510","56.5068493150684900","MULHER"
"251080805000031","1","91","58","149","61.073825503355710","38.9261744966442900","HOMEM"
"251080805000032","1","183","91","274","66.788321167883210","33.2116788321167900","HOMEM"
"251080805000033","1","94","78","172","54.651162790697676","45.3488372093023240","HOMEM"
"251080805000034","1","119","153","272","43.750000000000000","56.2500000000000000","MULHER"
"251080805000035","1","74","59","133","55.639097744360900","44.3609022556391000","HOMEM"
"251080805000036","1","167","108","275","60.727272727272730","39.2727272727272700","HOMEM"
"251080805000037","1","210","131","341","61.583577712609970","38.4164222873900300","HOMEM"
"251080805000038","1","193","110","303","63.696369636963695","36.3036303630363050","HOMEM"
"251080805000039","1","156","106","262","59.541984732824424","40.4580152671755760","HOMEM"
"251080805000040","1","79","52","131","60.305343511450380","39.6946564885496200","HOMEM"
"251080805000041","1","127","79","206","61.650485436893206","38.3495145631067940","HOMEM"
"251080805000042","1","143","70","213","67.136150234741790","32.8638497652582160","HOMEM"
"251080805000043","1","250","88","338","73.964497041420120","26.0355029585798830","HOMEM"
"251080805000044","1","168","153","321","52.336448598130840","47.6635514018691600","HOMEM"
"251080805000045","1","127","51","178","71.348314606741570","28.6516853932584250","HOMEM"
"251080805000046","1","173","110","283","61.130742049469966","38.8692579505300340","HOMEM"
"251080805000047","1","96","64","160","60.000000000000000","40.0000000000000000","HOMEM"
"251080805000048","1","0","0","0",NULL,NULL,NULL
"251080805000049","1","352","131","483","72.877846790890270","27.1221532091097300","HOMEM"
"251080805000050","1","131","99","230","56.956521739130440","43.0434782608695600","HOMEM"
"251080805000051","1","150","41","191","78.534031413612570","21.4659685863874330","HOMEM"
"251080805000052","1","78","65","143","54.545454545454550","45.4545454545454500","HOMEM"
"251080805000053","1","82","89","171","47.953216374269005","52.0467836257309950","MULHER"
"251080805000054","1","82","32","114","71.929824561403500","28.0701754385964900","HOMEM"
"251080805000055","1","136","44","180","75.555555555555560","24.4444444444444430","HOMEM"
"251080805000056","1","125","63","188","66.489361702127650","33.5106382978723400","HOMEM"
"251080805000057","1","88","63","151","58.278145695364240","41.7218543046357600","HOMEM"
"251080805000058","1","222","99","321","69.158878504672900","30.8411214953271000","HOMEM"
"251080805000059","1","241","86","327","73.700305810397550","26.2996941896024480","HOMEM"
"251080805000060","1","118","69","187","63.101604278074866","36.8983957219251340","HOMEM"
"251080805000061","1","282","92","374","75.401069518716580","24.5989304812834200","HOMEM"
"251080805000062","1","63","35","98","64.285714285714290","35.7142857142857150","HOMEM"
"251080805000063","1","156","102","258","60.465116279069770","39.5348837209302300","HOMEM"
"251080805000064","1","79","201","280","28.214285714285715","71.7857142857142900","MULHER"
"251080805000065","1","153","80","233","65.665236051502150","34.3347639484978500","HOMEM"
"251080805000066","1","194","80","274","70.802919708029200","29.1970802919708030","HOMEM"
"251080805000067","1","133","117","250","53.200000000000000","46.8000000000000000","HOMEM"
"251080805000068","1","154","164","318","48.427672955974840","51.5723270440251600","MULHER"
"251080805000069","1","96","44","140","68.571428571428570","31.4285714285714270","HOMEM"
"251080805000070","1","104","60","164","63.414634146341460","36.5853658536585400","HOMEM"
"251080805000071","1","138","66","204","67.647058823529400","32.3529411764705900","HOMEM"
"251080805000072","1","162","26","188","86.170212765957440","13.8297872340425540","HOMEM"
"251080805000073","1","117","60","177","66.101694915254240","33.8983050847457650","HOMEM"
"251080805000074","1","277","188","465","59.569892473118280","40.4301075268817200","HOMEM"
"251080805000075","1","143","78","221","64.705882352941170","35.2941176470588260","HOMEM"
"251080805000076","1","179","122","301","59.468438538205980","40.5315614617940200","HOMEM"
"251080805000077","1","0","0","0",NULL,NULL,NULL
"251080805000078","1","98","82","180","54.444444444444440","45.5555555555555600","HOMEM"
"251080805000079","1","167","158","325","51.384615384615390","48.6153846153846100","HOMEM"
"251080805000080","1","0","0","0",NULL,NULL,NULL
"251080805000081","1","90","49","139","64.748201438848920","35.2517985611510800","HOMEM"
"251080805000082","1","57","159","216","26.388888888888890","73.6111111111111100","MULHER"
"251080805000083","1","14","3","17","82.352941176470600","17.6470588235294130","HOMEM"
"251080805000084","1","11","4","15","73.333333333333330","26.6666666666666680","HOMEM"
"251080805000085","1","84","41","125","67.200000000000000","32.8000000000000000","HOMEM"
"251080805000086","1","230","166","396","58.080808080808080","41.9191919191919200","HOMEM"
"251080805000087","1","161","158","319","50.470219435736674","49.5297805642633260","HOMEM"
"251080805000088","1","49","30","79","62.025316455696200","37.9746835443038000","HOMEM"
"251080805000089","1","0","0","0",NULL,NULL,NULL
"251080805000090","1","3","3","6","50.000000000000000","50.0000000000000000","IGUAL"
"251080805000091","1","25","45","70","35.714285714285715","64.2857142857142900","MULHER"
"251080805000092","1","29","36","65","44.615384615384610","55.3846153846153900","MULHER"
"251080805000093","1","67","47","114","58.771929824561404","41.2280701754385960","HOMEM"
"251080805000094","1","48","53","101","47.524752475247524","52.4752475247524760","MULHER"
"251080805000095","1","9","15","24","37.500000000000000","62.5000000000000000","MULHER"
"251080805000096","1","64","30","94","68.085106382978720","31.9148936170212780","HOMEM"
"251080805000097","1","22","16","38","57.894736842105260","42.1052631578947400","HOMEM"
"251080805000098","1","29","31","60","48.333333333333336","51.6666666666666640","MULHER"
"251080805000099","1","195","54","249","78.313253012048200","21.6867469879518070","HOMEM"
"251080805000100","1","5","2","7","71.428571428571430","28.5714285714285730","HOMEM"
"251080805000101","1","54","16","70","77.142857142857140","22.8571428571428580","HOMEM"
"251080805000102","1","306","132","438","69.863013698630140","30.1369863013698630","HOMEM"
"251080805000103","1","3","3","6","50.000000000000000","50.0000000000000000","IGUAL"
"251080805000104","1","14","19","33","42.424242424242420","57.5757575757575800","MULHER"
"251080805000105","1","65","10","75","86.666666666666670","13.3333333333333340","HOMEM"
"251080805000106","8","131","34","165","79.393939393939390","20.6060606060606060","HOMEM"
"251080805000107","8","101","29","130","77.692307692307700","22.3076923076923070","HOMEM"
"251080805000108","8","119","13","132","90.151515151515160","9.8484848484848480","HOMEM"
"251080805000109","8","8","2","10","80.000000000000000","20.0000000000000000","HOMEM"
"251080805000110","7","50","8","58","86.206896551724140","13.7931034482758610","HOMEM"
"251080805000111","8","145","16","161","90.062111801242240","9.9378881987577630","HOMEM"
"251080805000112","1","124","88","212","58.490566037735846","41.5094339622641540","HOMEM"
"251080805000113","1","44","66","110","40.000000000000000","60.0000000000000000","MULHER"
"251080805000114","1","103","82","185","55.675675675675680","44.3243243243243200","HOMEM"
"251080805000115","1","99","67","166","59.638554216867470","40.3614457831325300","HOMEM"
"251080805000116","1","217","110","327","66.360856269113160","33.6391437308868500","HOMEM"
"251080805000117","1","120","127","247","48.582995951417004","51.4170040485829960","MULHER"
"251080805000118","1","141","76","217","64.976958525345620","35.0230414746543800","HOMEM"
"251080805000119","1","132","55","187","70.588235294117650","29.4117647058823500","HOMEM"
"251080805000120","1","215","75","290","74.137931034482760","25.8620689655172420","HOMEM"
"251080805000121","1","145","72","217","66.820276497695860","33.1797235023041500","HOMEM"
"251080805000122","1","144","84","228","63.157894736842100","36.8421052631579000","HOMEM"
"251080805000123","1","109","69","178","61.235955056179776","38.7640449438202240","HOMEM"
"251080805000124","1","79","207","286","27.622377622377623","72.3776223776223700","MULHER"
"251080805000125","1","142","52","194","73.195876288659790","26.8041237113402070","HOMEM"
"251080805000126","1","197","106","303","65.016501650165010","34.9834983498349800","HOMEM"
"251080805000127","1","110","72","182","60.439560439560440","39.5604395604395600","HOMEM"
"251080805000128","1","78","56","134","58.208955223880594","41.7910447761194060","HOMEM"
"251080805000129","1","75","66","141","53.191489361702125","46.8085106382978750","HOMEM"
"251080805000130","1","128","61","189","67.724867724867720","32.2751322751322700","HOMEM"
"251080805000131","1","94","88","182","51.648351648351650","48.3516483516483500","HOMEM"
"251080805000132","1","58","33","91","63.736263736263740","36.2637362637362600","HOMEM"
"251080805000133","1","170","85","255","66.666666666666670","33.3333333333333360","HOMEM"
"251080805000134","1","141","81","222","63.513513513513516","36.4864864864864840","HOMEM"
"251080805000135","1","45","214","259","17.374517374517374","82.6254826254826200","MULHER"
"251080805000136","1","156","113","269","57.992565055762080","42.0074349442379200","HOMEM"
"251080805000137","1","55","53","108","50.925925925925924","49.0740740740740760","HOMEM"
"251080805000138","1","110","93","203","54.187192118226600","45.8128078817734000","HOMEM"
"251080805000139","1","123","74","197","62.436548223350250","37.5634517766497500","HOMEM"
"251080805000140","1","148","53","201","73.631840796019900","26.3681592039801000","HOMEM"
"251080805000141","1","118","80","198","59.595959595959600","40.4040404040404000","HOMEM"
"251080805000142","1","64","111","175","36.571428571428570","63.4285714285714300","MULHER"
"251080805000143","1","80","83","163","49.079754601226995","50.9202453987730050","MULHER"
"251080805000144","1","118","72","190","62.105263157894740","37.8947368421052600","HOMEM"
"251080810000001","1","176","102","278","63.309352517985610","36.6906474820143900","HOMEM"
"251080810000002","8","74","27","101","73.267326732673270","26.7326732673267300","HOMEM"
"251080810000003","8","134","23","157","85.350318471337570","14.6496815286624200","HOMEM"
"251090705000001","1","156","129","285","54.736842105263160","45.2631578947368400","HOMEM"
"251090705000002","1","50","213","263","19.011406844106464","80.9885931558935400","MULHER"
"251090705000003","1","163","78","241","67.634854771784230","32.3651452282157660","HOMEM"
"251090705000004","8","41","86","127","32.283464566929130","67.7165354330708600","MULHER"
"251090705000005","8","49","5","54","90.740740740740750","9.2592592592592600","HOMEM"
"251090705000006","8","108","36","144","75.000000000000000","25.0000000000000000","HOMEM"
"251090705000007","8","116","13","129","89.922480620155040","10.0775193798449610","HOMEM"
"251090705000008","8","31","110","141","21.985815602836880","78.0141843971631200","MULHER"
"251090705000009","8","159","26","185","85.945945945945950","14.0540540540540540","HOMEM"
"251090705000010","8","69","7","76","90.789473684210520","9.2105263157894740","HOMEM"
"251090705000011","1","127","246","373","34.048257372654156","65.9517426273458500","MULHER"
"251090705000012","1","204","75","279","73.118279569892480","26.8817204301075280","HOMEM"
"251090707000001","1","105","63","168","62.500000000000000","37.5000000000000000","HOMEM"
"251090707000002","8","22","80","102","21.568627450980394","78.4313725490196100","MULHER"
"251090707000003","8","165","35","200","82.500000000000000","17.5000000000000000","HOMEM"
"251090710000001","1","57","21","78","73.076923076923080","26.9230769230769230","HOMEM"
"251090710000002","8","132","28","160","82.500000000000000","17.5000000000000000","HOMEM"
"251090710000003","8","241","48","289","83.391003460207610","16.6089965397923860","HOMEM"
"251100405000001","1","279","88","367","76.021798365122620","23.9782016348773830","HOMEM"
"251100405000002","1","199","90","289","68.858131487889270","31.1418685121107260","HOMEM"
"251100405000003","8","118","27","145","81.379310344827590","18.6206896551724130","HOMEM"
"251100405000004","8","60","15","75","80.000000000000000","20.0000000000000000","HOMEM"
"251100405000005","8","98","18","116","84.482758620689650","15.5172413793103450","HOMEM"
"251110305000001","1","169","106","275","61.454545454545450","38.5454545454545500","HOMEM"
"251110305000002","1","118","82","200","59.000000000000000","41.0000000000000000","HOMEM"
"251110305000003","8","93","23","116","80.172413793103440","19.8275862068965500","HOMEM"
"251110305000004","8","58","6","64","90.625000000000000","9.3750000000000000","HOMEM"
"251110305000005","8","230","70","300","76.666666666666670","23.3333333333333320","HOMEM"
"251110305000006","8","305","104","409","74.572127139364300","25.4278728606357000","HOMEM"
"251110305000007","8","206","135","341","60.410557184750736","39.5894428152492640","HOMEM"
"251110305000008","8","13","3","16","81.250000000000000","18.7500000000000000","HOMEM"
"251110305000009","1","158","64","222","71.171171171171170","28.8288288288288300","HOMEM"
"251110305000010","1","165","101","266","62.030075187969930","37.9699248120300700","HOMEM"
"251110305000011","5","22","8","30","73.333333333333330","26.6666666666666680","HOMEM"
"251120205000001","1","178","140","318","55.974842767295600","44.0251572327044000","HOMEM"
"251120205000002","1","183","164","347","52.737752161383284","47.2622478386167160","HOMEM"
"251120205000003","1","129","77","206","62.621359223300970","37.3786407766990300","HOMEM"
"251120205000004","1","129","72","201","64.179104477611940","35.8208955223880600","HOMEM"
"251120205000005","1","226","129","355","63.661971830985910","36.3380281690140900","HOMEM"
"251120205000006","1","309","168","477","64.779874213836480","35.2201257861635200","HOMEM"
"251120205000007","1","206","125","331","62.235649546827794","37.7643504531722060","HOMEM"
"251120205000008","1","146","132","278","52.517985611510790","47.4820143884892100","HOMEM"
"251120205000009","1","153","171","324","47.222222222222220","52.7777777777777800","MULHER"
"251120205000010","1","423","173","596","70.973154362416110","29.0268456375838930","HOMEM"
"251120205000011","1","211","161","372","56.720430107526880","43.2795698924731200","HOMEM"
"251120205000012","1","228","92","320","71.250000000000000","28.7500000000000000","HOMEM"
"251120205000013","1","207","69","276","75.000000000000000","25.0000000000000000","HOMEM"
"251120205000014","8","67","13","80","83.750000000000000","16.2500000000000000","HOMEM"
"251120205000015","8","105","27","132","79.545454545454550","20.4545454545454530","HOMEM"
"251120205000016","5","54","67","121","44.628099173553720","55.3719008264462800","MULHER"
"251120205000017","8","345","70","415","83.132530120481930","16.8674698795180720","HOMEM"
"251120205000018","8","167","32","199","83.919597989949750","16.0804020100502500","HOMEM"
"251120205000019","8","173","36","209","82.775119617224870","17.2248803827751200","HOMEM"
"251120205000020","8","231","31","262","88.167938931297710","11.8320610687022900","HOMEM"
"251120205000021","5","7","24","31","22.580645161290324","77.4193548387096800","MULHER"
"251120205000022","8","149","47","196","76.020408163265300","23.9795918367346950","HOMEM"
"251120205000023","8","12","21","33","36.363636363636370","63.6363636363636300","MULHER"
"251120205000024","8","81","26","107","75.700934579439250","24.2990654205607480","HOMEM"
"251120205000025","8","180","21","201","89.552238805970150","10.4477611940298520","HOMEM"
"251120205000026","8","133","70","203","65.517241379310350","34.4827586206896600","HOMEM"
"251120205000027","8","72","23","95","75.789473684210520","24.2105263157894730","HOMEM"
"251120205000028","5","130","18","148","87.837837837837840","12.1621621621621610","HOMEM"
"251120205000029","8","248","48","296","83.783783783783790","16.2162162162162180","HOMEM"
"251120205000030","8","26","3","29","89.655172413793110","10.3448275862068970","HOMEM"
"251120205000031","1","73","36","109","66.972477064220190","33.0275229357798140","HOMEM"
"251120205000032","1","81","36","117","69.230769230769230","30.7692307692307700","HOMEM"
"251130105000001","1","218","113","331","65.861027190332320","34.1389728096676700","HOMEM"
"251130105000002","1","226","167","393","57.506361323155220","42.4936386768447800","HOMEM"
"251130105000003","1","280","80","360","77.777777777777770","22.2222222222222200","HOMEM"
"251130105000004","1","171","260","431","39.675174013921115","60.3248259860788850","MULHER"
"251130105000005","1","301","119","420","71.666666666666670","28.3333333333333320","HOMEM"
"251130105000006","1","180","100","280","64.285714285714290","35.7142857142857150","HOMEM"
"251130105000007","1","182","120","302","60.264900662251655","39.7350993377483450","HOMEM"
"251130105000008","1","233","162","395","58.987341772151900","41.0126582278481000","HOMEM"
"251130105000009","1","151","87","238","63.445378151260506","36.5546218487394940","HOMEM"
"251130105000010","1","154","99","253","60.869565217391305","39.1304347826086950","HOMEM"
"251130105000011","8","210","32","242","86.776859504132230","13.2231404958677690","HOMEM"
"251130105000012","8","127","12","139","91.366906474820140","8.6330935251798560","HOMEM"
"251130105000013","8","151","17","168","89.880952380952380","10.1190476190476190","HOMEM"
"251130105000014","8","85","60","145","58.620689655172410","41.3793103448275900","HOMEM"
"251130105000015","8","51","89","140","36.428571428571430","63.5714285714285700","MULHER"
"251130105000016","8","13","44","57","22.807017543859650","77.1929824561403600","MULHER"
"251130105000017","8","144","39","183","78.688524590163940","21.3114754098360670","HOMEM"
"251130105000018","8","89","8","97","91.752577319587630","8.2474226804123700","HOMEM"
"251130105000019","5","17","25","42","40.476190476190474","59.5238095238095260","MULHER"
"251140005000001","1","148","128","276","53.623188405797100","46.3768115942029000","HOMEM"
"251140005000002","1","127","74","201","63.184079601990050","36.8159203980099500","HOMEM"
"251140005000003","1","205","66","271","75.645756457564570","24.3542435424354230","HOMEM"
"251140005000004","1","109","130","239","45.606694560669450","54.3933054393305500","MULHER"
"251140005000005","1","72","72","144","50.000000000000000","50.0000000000000000","IGUAL"
"251140005000006","1","105","72","177","59.322033898305090","40.6779661016949100","HOMEM"
"251140005000007","1","140","123","263","53.231939163498100","46.7680608365019000","HOMEM"
"251140005000008","1","78","100","178","43.820224719101130","56.1797752808988700","MULHER"
"251140005000009","1","109","69","178","61.235955056179776","38.7640449438202240","HOMEM"
"251140005000010","1","148","108","256","57.812500000000000","42.1875000000000000","HOMEM"
"251140005000011","8","62","18","80","77.500000000000000","22.5000000000000000","HOMEM"
"251140005000012","8","58","34","92","63.043478260869560","36.9565217391304400","HOMEM"
"251140005000013","8","19","22","41","46.341463414634150","53.6585365853658500","MULHER"
"251140005000014","8","62","16","78","79.487179487179490","20.5128205128205150","HOMEM"
"251140005000015","8","78","40","118","66.101694915254240","33.8983050847457650","HOMEM"
"251140005000016","5","133","32","165","80.606060606060610","19.3939393939393940","HOMEM"
"251140005000017","8","29","16","45","64.444444444444440","35.5555555555555600","HOMEM"
"251140005000018","8","29","2","31","93.548387096774190","6.4516129032258060","HOMEM"
"251140005000019","8","54","10","64","84.375000000000000","15.6250000000000000","HOMEM"
"251140005000020","8","170","27","197","86.294416243654820","13.7055837563451770","HOMEM"
"251140005000021","8","88","88","176","50.000000000000000","50.0000000000000000","IGUAL"
"251140005000022","8","60","9","69","86.956521739130440","13.0434782608695650","HOMEM"
"251140005000023","8","98","18","116","84.482758620689650","15.5172413793103450","HOMEM"
"251140005000024","8","39","14","53","73.584905660377360","26.4150943396226400","HOMEM"
"251140005000025","8","3","3","6","50.000000000000000","50.0000000000000000","IGUAL"
"251140005000026","8","17","2","19","89.473684210526320","10.5263157894736850","HOMEM"
"251140005000027","8","56","15","71","78.873239436619710","21.1267605633802800","HOMEM"
"251140005000028","8","63","23","86","73.255813953488370","26.7441860465116300","HOMEM"
"251140005000029","1","108","138","246","43.902439024390250","56.0975609756097500","MULHER"
"251140005000030","1","146","64","210","69.523809523809520","30.4761904761904740","HOMEM"
"251140005000031","1","117","110","227","51.541850220264315","48.4581497797356850","HOMEM"
"251140005000032","1","88","164","252","34.920634920634920","65.0793650793650800","MULHER"
"251140005000033","1","162","107","269","60.223048327137550","39.7769516728624500","HOMEM"
"251140005000034","1","88","73","161","54.658385093167700","45.3416149068323000","HOMEM"
"251140005000035","1","73","92","165","44.242424242424240","55.7575757575757600","MULHER"
"251140005000036","5","158","58","216","73.148148148148150","26.8518518518518500","HOMEM"
"251150905000001","1","157","131","288","54.513888888888886","45.4861111111111140","HOMEM"
"251150905000002","1","126","86","212","59.433962264150940","40.5660377358490600","HOMEM"
"251150905000003","1","97","47","144","67.361111111111110","32.6388888888888860","HOMEM"
"251150905000004","1","234","149","383","61.096605744125330","38.9033942558746700","HOMEM"
"251150905000005","1","126","57","183","68.852459016393440","31.1475409836065570","HOMEM"
"251150905000006","1","130","202","332","39.156626506024100","60.8433734939759000","MULHER"
"251150905000007","1","117","95","212","55.188679245283020","44.8113207547169800","HOMEM"
"251150905000008","8","154","83","237","64.978902953586500","35.0210970464135000","HOMEM"
"251150905000009","5","115","50","165","69.696969696969700","30.3030303030303050","HOMEM"
"251150905000010","8","86","17","103","83.495145631067960","16.5048543689320400","HOMEM"
"251150905000011","8","44","30","74","59.459459459459460","40.5405405405405400","HOMEM"
"251150905000012","8","81","187","268","30.223880597014926","69.7761194029850700","MULHER"
"251150905000013","1","132","89","221","59.728506787330320","40.2714932126696800","HOMEM"
"251150905000014","1","137","90","227","60.352422907488986","39.6475770925110140","HOMEM"
"251150905000015","5","22","7","29","75.862068965517240","24.1379310344827580","HOMEM"
"251150905000016","5","70","28","98","71.428571428571430","28.5714285714285730","HOMEM"
"251160805000001","1","97","87","184","52.717391304347830","47.2826086956521700","HOMEM"
"251160805000002","1","109","104","213","51.173708920187790","48.8262910798122100","HOMEM"
"251160805000003","8","72","42","114","63.157894736842100","36.8421052631579000","HOMEM"
"251160805000004","8","139","30","169","82.248520710059170","17.7514792899408300","HOMEM"
"251160805000005","8","31","12","43","72.093023255813950","27.9069767441860460","HOMEM"
"251160805000006","8","176","39","215","81.860465116279070","18.1395348837209300","HOMEM"
"251160805000007","8","55","15","70","78.571428571428570","21.4285714285714270","HOMEM"
"251160805000008","8","55","11","66","83.333333333333330","16.6666666666666680","HOMEM"
"251160805000009","8","107","41","148","72.297297297297290","27.7027027027027000","HOMEM"
"251160805000010","1","130","95","225","57.777777777777780","42.2222222222222200","HOMEM"
"251160805000011","1","176","93","269","65.427509293680300","34.5724907063197050","HOMEM"
"251170705000001","1","103","83","186","55.376344086021504","44.6236559139784960","HOMEM"
"251170705000002","1","72","122","194","37.113402061855670","62.8865979381443300","MULHER"
"251170705000003","8","30","41","71","42.253521126760560","57.7464788732394400","MULHER"
"251170705000004","8","93","29","122","76.229508196721310","23.7704918032786880","HOMEM"
"251170705000005","8","48","7","55","87.272727272727270","12.7272727272727270","HOMEM"
"251170705000006","8","60","128","188","31.914893617021278","68.0851063829787200","MULHER"
"251170705000007","8","81","81","162","50.000000000000000","50.0000000000000000","IGUAL"
"251170705000008","1","136","86","222","61.261261261261260","38.7387387387387400","HOMEM"
"251170705000009","1","114","111","225","50.666666666666664","49.3333333333333360","HOMEM"
"251180605000001","1","127","118","245","51.836734693877550","48.1632653061224500","HOMEM"
"251180605000002","1","134","85","219","61.187214611872140","38.8127853881278600","HOMEM"
"251180605000003","1","131","111","242","54.132231404958680","45.8677685950413200","HOMEM"
"251180605000004","1","159","95","254","62.598425196850390","37.4015748031496100","HOMEM"
"251180605000005","1","154","128","282","54.609929078014180","45.3900709219858200","HOMEM"
"251180605000006","1","187","91","278","67.266187050359720","32.7338129496402900","HOMEM"
"251180605000007","1","182","135","317","57.413249211356465","42.5867507886435350","HOMEM"
"251180605000008","1","168","72","240","70.000000000000000","30.0000000000000000","HOMEM"
"251180605000009","1","139","95","234","59.401709401709404","40.5982905982905960","HOMEM"
"251180605000010","8","26","9","35","74.285714285714290","25.7142857142857150","HOMEM"
"251180605000011","8","62","19","81","76.543209876543220","23.4567901234567900","HOMEM"
"251180605000012","8","13","2","15","86.666666666666670","13.3333333333333340","HOMEM"
"251180605000013","8","37","16","53","69.811320754716990","30.1886792452830200","HOMEM"
"251180605000014","8","43","31","74","58.108108108108105","41.8918918918918950","HOMEM"
"251180605000015","8","28","46","74","37.837837837837840","62.1621621621621600","MULHER"
"251180605000016","8","153","37","190","80.526315789473680","19.4736842105263150","HOMEM"
"251180605000017","8","26","11","37","70.270270270270270","29.7297297297297300","HOMEM"
"251180605000018","8","11","3","14","78.571428571428570","21.4285714285714270","HOMEM"
"251180605000019","8","39","17","56","69.642857142857140","30.3571428571428580","HOMEM"
"251190505000001","1","45","22","67","67.164179104477610","32.8358208955223900","HOMEM"
"251190505000002","1","131","74","205","63.902439024390250","36.0975609756097500","HOMEM"
"251190505000003","1","73","55","128","57.031250000000000","42.9687500000000000","HOMEM"
"251190505000004","1","76","30","106","71.698113207547170","28.3018867924528300","HOMEM"
"251190505000005","1","59","84","143","41.258741258741260","58.7412587412587400","MULHER"
"251190505000006","1","35","10","45","77.777777777777770","22.2222222222222200","HOMEM"
"251190505000007","1","269","194","463","58.099352051835850","41.9006479481641500","HOMEM"
"251190505000008","1","276","194","470","58.723404255319146","41.2765957446808540","HOMEM"
"251190505000009","1","27","8","35","77.142857142857140","22.8571428571428580","HOMEM"
"251190505000010","8","13","3","16","81.250000000000000","18.7500000000000000","HOMEM"
"251190505000011","7","30","87","117","25.641025641025642","74.3589743589743600","MULHER"
"251190505000012","7","31","16","47","65.957446808510640","34.0425531914893600","HOMEM"
"251190505000013","8","18","8","26","69.230769230769230","30.7692307692307700","HOMEM"
"251190505000014","5","89","28","117","76.068376068376070","23.9316239316239320","HOMEM"
"251190505000015","5","83","32","115","72.173913043478270","27.8260869565217400","HOMEM"
"251190505000016","8","72","8","80","90.000000000000000","10.0000000000000000","HOMEM"
"251190505000017","8","414","73","487","85.010266940451740","14.9897330595482550","HOMEM"
"251190505000018","7","46","88","134","34.328358208955220","65.6716417910447800","MULHER"
"251190505000019","7","164","31","195","84.102564102564100","15.8974358974358980","HOMEM"
"251190505000020","7","17","36","53","32.075471698113205","67.9245283018868000","MULHER"
"251190505000021","5","54","9","63","85.714285714285710","14.2857142857142860","HOMEM"
"251190505000022","1","139","81","220","63.181818181818180","36.8181818181818200","HOMEM"
"251190505000023","1","37","79","116","31.896551724137932","68.1034482758620600","MULHER"
"251190505000024","1","114","96","210","54.285714285714285","45.7142857142857150","HOMEM"
"251190505000025","1","88","54","142","61.971830985915496","38.0281690140845040","HOMEM"
"251190505000026","5","42","164","206","20.388349514563107","79.6116504854369000","MULHER"
"251190505000027","8","61","29","90","67.777777777777770","32.2222222222222200","HOMEM"
"251190505000028","1","36","15","51","70.588235294117650","29.4117647058823500","HOMEM"
"251190505000029","1","123","98","221","55.656108597285070","44.3438914027149300","HOMEM"
"251190505000030","1","25","5","30","83.333333333333330","16.6666666666666680","HOMEM"
"251190505000031","1","32","9","41","78.048780487804880","21.9512195121951240","HOMEM"
"251190505000032","1","106","52","158","67.088607594936700","32.9113924050632900","HOMEM"
"251190505000033","1","65","38","103","63.106796116504850","36.8932038834951500","HOMEM"
"251200205000001","1","183","130","313","58.466453674121404","41.5335463258785960","HOMEM"
"251200205000002","1","135","126","261","51.724137931034484","48.2758620689655160","HOMEM"
"251200205000003","1","143","211","354","40.395480225988700","59.6045197740113000","MULHER"
"251200205000004","1","165","87","252","65.476190476190480","34.5238095238095260","HOMEM"
"251200205000005","1","252","80","332","75.903614457831320","24.0963855421686760","HOMEM"
"251200205000006","1","189","81","270","70.000000000000000","30.0000000000000000","HOMEM"
"251200205000007","1","113","117","230","49.130434782608695","50.8695652173913050","MULHER"
"251200205000008","1","112","110","222","50.450450450450454","49.5495495495495460","HOMEM"
"251200205000009","8","98","7","105","93.333333333333330","6.6666666666666670","HOMEM"
"251200205000010","8","127","36","163","77.914110429447860","22.0858895705521480","HOMEM"
"251200205000011","8","233","77","310","75.161290322580640","24.8387096774193560","HOMEM"
"251200205000012","8","125","37","162","77.160493827160500","22.8395061728395060","HOMEM"
"251200205000013","8","149","25","174","85.632183908045970","14.3678160919540230","HOMEM"
"251200205000014","8","102","40","142","71.830985915492960","28.1690140845070440","HOMEM"
"251200205000015","8","207","44","251","82.470119521912350","17.5298804780876480","HOMEM"
"251200205000016","8","64","17","81","79.012345679012340","20.9876543209876550","HOMEM"
"251200205000017","8","124","47","171","72.514619883040940","27.4853801169590640","HOMEM"
"251200205000018","4","55","17","72","76.388888888888890","23.6111111111111100","HOMEM"
"251200205000019","4","45","44","89","50.561797752808985","49.4382022471910150","HOMEM"
"251200205000020","1","65","55","120","54.166666666666664","45.8333333333333360","HOMEM"
"251200205000021","1","116","57","173","67.052023121387280","32.9479768786127140","HOMEM"
"251200205000022","1","110","74","184","59.782608695652170","40.2173913043478300","HOMEM"
"251200210000001","1","40","23","63","63.492063492063494","36.5079365079365060","HOMEM"
"251200210000002","8","121","19","140","86.428571428571430","13.5714285714285710","HOMEM"
"251200210000003","8","86","58","144","59.722222222222220","40.2777777777777800","HOMEM"
"251203605000001","1","174","89","263","66.159695817490500","33.8403041825095060","HOMEM"
"251203605000002","8","199","37","236","84.322033898305080","15.6779661016949150","HOMEM"
"251203605000003","8","60","16","76","78.947368421052630","21.0526315789473700","HOMEM"
"251203605000004","8","80","23","103","77.669902912621350","22.3300970873786400","HOMEM"
"251203605000005","5","94","58","152","61.842105263157900","38.1578947368421000","HOMEM"
"251203605000006","5","140","21","161","86.956521739130440","13.0434782608695650","HOMEM"
"251207705000001","1","48","184","232","20.689655172413794","79.3103448275862000","MULHER"
"251207705000002","8","77","28","105","73.333333333333330","26.6666666666666680","HOMEM"
"251207705000003","8","65","82","147","44.217687074829930","55.7823129251700700","MULHER"
"251207705000004","8","206","58","264","78.030303030303030","21.9696969696969700","HOMEM"
"251207705000005","8","121","38","159","76.100628930817600","23.8993710691823900","HOMEM"
"251207705000006","1","79","139","218","36.238532110091750","63.7614678899082500","MULHER"
"251207705000007","5","17","45","62","27.419354838709676","72.5806451612903200","MULHER"
"251210105000001","1","177","102","279","63.440860215053760","36.5591397849462400","HOMEM"
"251210105000002","1","117","84","201","58.208955223880594","41.7910447761194060","HOMEM"
"251210105000003","1","135","89","224","60.267857142857146","39.7321428571428540","HOMEM"
"251210105000004","1","130","70","200","65.000000000000000","35.0000000000000000","HOMEM"
"251210105000005","1","259","151","410","63.170731707317074","36.8292682926829260","HOMEM"
"251210105000006","1","160","128","288","55.555555555555560","44.4444444444444400","HOMEM"
"251210105000007","1","150","130","280","53.571428571428570","46.4285714285714300","HOMEM"
"251210105000008","1","99","64","163","60.736196319018404","39.2638036809815960","HOMEM"
"251210105000009","1","74","38","112","66.071428571428570","33.9285714285714300","HOMEM"
"251210105000010","1","123","116","239","51.464435146443510","48.5355648535564900","HOMEM"
"251210105000011","1","181","71","252","71.825396825396820","28.1746031746031740","HOMEM"
"251210105000012","1","73","30","103","70.873786407766990","29.1262135922330100","HOMEM"
"251210105000013","1","128","136","264","48.484848484848484","51.5151515151515160","MULHER"
"251210105000014","1","76","74","150","50.666666666666664","49.3333333333333360","HOMEM"
"251210105000015","1","68","146","214","31.775700934579440","68.2242990654205700","MULHER"
"251210105000016","1","206","49","255","80.784313725490200","19.2156862745098030","HOMEM"
"251210105000017","1","151","73","224","67.410714285714290","32.5892857142857150","HOMEM"
"251210105000018","1","165","128","293","56.313993174061430","43.6860068259385700","HOMEM"
"251210105000019","1","207","87","294","70.408163265306130","29.5918367346938780","HOMEM"
"251210105000020","1","129","116","245","52.653061224489800","47.3469387755102000","HOMEM"
"251210105000021","1","155","107","262","59.160305343511450","40.8396946564885500","HOMEM"
"251210105000022","1","148","76","224","66.071428571428570","33.9285714285714300","HOMEM"
"251210105000023","8","93","11","104","89.423076923076920","10.5769230769230770","HOMEM"
"251210105000024","8","62","22","84","73.809523809523810","26.1904761904761900","HOMEM"
"251210105000025","8","22","4","26","84.615384615384610","15.3846153846153850","HOMEM"
"251210105000026","8","35","20","55","63.636363636363630","36.3636363636363700","HOMEM"
"251210105000027","8","49","4","53","92.452830188679240","7.5471698113207550","HOMEM"
"251210105000028","8","95","22","117","81.196581196581190","18.8034188034188040","HOMEM"
"251210105000029","8","69","16","85","81.176470588235290","18.8235294117647070","HOMEM"
"251210105000030","8","70","48","118","59.322033898305090","40.6779661016949100","HOMEM"
"251210105000031","8","54","5","59","91.525423728813560","8.4745762711864410","HOMEM"
"251210105000032","8","74","47","121","61.157024793388430","38.8429752066115700","HOMEM"
"251210105000033","8","158","24","182","86.813186813186820","13.1868131868131860","HOMEM"
"251210105000034","8","61","3","64","95.312500000000000","4.6875000000000000","HOMEM"
"251210105000035","8","64","4","68","94.117647058823540","5.8823529411764710","HOMEM"
"251210105000036","8","42","32","74","56.756756756756760","43.2432432432432400","HOMEM"
"251210105000037","1","94","73","167","56.287425149700596","43.7125748502994040","HOMEM"
"251210105000038","1","199","61","260","76.538461538461530","23.4615384615384600","HOMEM"
"251210105000039","1","202","185","387","52.196382428940570","47.8036175710594300","HOMEM"
"251210105000040","1","211","77","288","73.263888888888890","26.7361111111111100","HOMEM"
"251210105000041","1","58","51","109","53.211009174311926","46.7889908256880740","HOMEM"
"251210105000042","1","132","57","189","69.841269841269830","30.1587301587301580","HOMEM"
"251210105000043","1","108","160","268","40.298507462686565","59.7014925373134350","MULHER"
"251210105000044","1","154","132","286","53.846153846153850","46.1538461538461500","HOMEM"
"251210105000045","1","120","91","211","56.872037914691944","43.1279620853080560","HOMEM"
"251210105000046","1","107","29","136","78.676470588235290","21.3235294117647070","HOMEM"
"251210115000001","1","35","15","50","70.000000000000000","30.0000000000000000","HOMEM"
"251210115000002","8","107","14","121","88.429752066115700","11.5702479338842980","HOMEM"
"251210115000003","8","179","44","223","80.269058295964130","19.7309417040358750","HOMEM"
"251210115000005","8","35","6","41","85.365853658536580","14.6341463414634150","HOMEM"
"251210115000006","8","61","6","67","91.044776119402980","8.9552238805970140","HOMEM"
"251210115000007","8","82","7","89","92.134831460674160","7.8651685393258420","HOMEM"
"251220005000001","1","157","104","261","60.153256704980840","39.8467432950191600","HOMEM"
"251220005000002","1","178","91","269","66.171003717472120","33.8289962825278800","HOMEM"
"251220005000003","1","106","117","223","47.533632286995510","52.4663677130044900","MULHER"
"251220005000004","8","174","47","221","78.733031674208150","21.2669683257918540","HOMEM"
"251220005000005","8","133","40","173","76.878612716763000","23.1213872832369950","HOMEM"
"251230905000001","1","65","45","110","59.090909090909090","40.9090909090909100","HOMEM"
"251230905000002","1","91","71","162","56.172839506172840","43.8271604938271600","HOMEM"
"251230905000003","1","122","81","203","60.098522167487690","39.9014778325123100","HOMEM"
"251230905000004","1","189","62","251","75.298804780876500","24.7011952191235050","HOMEM"
"251230905000005","1","133","156","289","46.020761245674740","53.9792387543252600","MULHER"
"251230905000006","1","183","129","312","58.653846153846150","41.3461538461538500","HOMEM"
"251230905000007","1","83","47","130","63.846153846153850","36.1538461538461500","HOMEM"
"251230905000008","1","100","57","157","63.694267515923560","36.3057324840764400","HOMEM"
"251230905000009","1","137","75","212","64.622641509433960","35.3773584905660400","HOMEM"
"251230905000010","1","186","88","274","67.883211678832110","32.1167883211678800","HOMEM"
"251230905000011","8","109","21","130","83.846153846153840","16.1538461538461530","HOMEM"
"251230905000012","8","34","6","40","85.000000000000000","15.0000000000000000","HOMEM"
"251230905000013","5","111","70","181","61.325966850828730","38.6740331491712700","HOMEM"
"251230905000014","8","93","13","106","87.735849056603770","12.2641509433962260","HOMEM"
"251230905000015","8","176","62","238","73.949579831932770","26.0504201680672270","HOMEM"
"251230905000016","8","70","9","79","88.607594936708860","11.3924050632911400","HOMEM"
"251230905000017","8","197","110","307","64.169381107491860","35.8306188925081400","HOMEM"
"251230905000018","8","136","23","159","85.534591194968560","14.4654088050314460","HOMEM"
"251230905000019","8","75","21","96","78.125000000000000","21.8750000000000000","HOMEM"
"251230905000020","8","93","39","132","70.454545454545450","29.5454545454545470","HOMEM"
"251230905000021","1","247","169","416","59.375000000000000","40.6250000000000000","HOMEM"
"251230905000022","1","100","76","176","56.818181818181820","43.1818181818181800","HOMEM"
"251230905000023","1","79","83","162","48.765432098765430","51.2345679012345700","MULHER"
"251230905000024","1","128","85","213","60.093896713615024","39.9061032863849760","HOMEM"
"251230905000025","1","133","151","284","46.830985915492960","53.1690140845070400","MULHER"
"251230905000026","1","132","48","180","73.333333333333330","26.6666666666666680","HOMEM"
"251230905000027","1","107","79","186","57.526881720430104","42.4731182795698960","HOMEM"
"251230905000028","1","152","82","234","64.957264957264950","35.0427350427350460","HOMEM"
"251230905000029","1","193","108","301","64.119601328903660","35.8803986710963440","HOMEM"
"251230905000030","5","31","64","95","32.631578947368420","67.3684210526315800","MULHER"
"251230905000031","5","96","25","121","79.338842975206620","20.6611570247933900","HOMEM"
"251230905000032","5","64","16","80","80.000000000000000","20.0000000000000000","HOMEM"
"251240805000001","1","122","109","231","52.813852813852810","47.1861471861471900","HOMEM"
"251240805000002","1","135","68","203","66.502463054187190","33.4975369458128100","HOMEM"
"251240805000003","1","149","107","256","58.203125000000000","41.7968750000000000","HOMEM"
"251240805000004","1","171","108","279","61.290322580645160","38.7096774193548400","HOMEM"
"251240805000005","8","65","27","92","70.652173913043480","29.3478260869565230","HOMEM"
"251240805000006","8","60","20","80","75.000000000000000","25.0000000000000000","HOMEM"
"251240805000007","4","151","76","227","66.519823788546260","33.4801762114537450","HOMEM"
"251240805000008","8","235","72","307","76.547231270358310","23.4527687296416940","HOMEM"
"251240805000009","8","43","39","82","52.439024390243900","47.5609756097561000","HOMEM"
"251240805000010","8","105","29","134","78.358208955223890","21.6417910447761200","HOMEM"
"251240805000011","4","92","34","126","73.015873015873010","26.9841269841269840","HOMEM"
"251240805000012","4","226","111","337","67.062314540059350","32.9376854599406500","HOMEM"
"251240805000013","8","88","46","134","65.671641791044780","34.3283582089552200","HOMEM"
"251240805000014","8","147","64","211","69.668246445497630","30.3317535545023700","HOMEM"
"251240805000015","8","175","58","233","75.107296137339060","24.8927038626609440","HOMEM"
"251240805000016","8","74","16","90","82.222222222222230","17.7777777777777800","HOMEM"
"251240805000017","8","122","86","208","58.653846153846150","41.3461538461538500","HOMEM"
"251240805000018","8","108","45","153","70.588235294117650","29.4117647058823500","HOMEM"
"251240805000019","1","101","52","153","66.013071895424840","33.9869281045751600","HOMEM"
"251240805000020","1","89","50","139","64.028776978417270","35.9712230215827300","HOMEM"
"251250705000001","1","148","133","281","52.669039145907476","47.3309608540925240","HOMEM"
"251250705000002","1","228","121","349","65.329512893982810","34.6704871060171900","HOMEM"
"251250705000003","1","184","74","258","71.317829457364340","28.6821705426356600","HOMEM"
"251250705000004","1","180","142","322","55.900621118012424","44.0993788819875760","HOMEM"
"251250705000005","1","150","123","273","54.945054945054940","45.0549450549450600","HOMEM"
"251250705000006","1","193","50","243","79.423868312757210","20.5761316872428000","HOMEM"
"251250705000007","1","88","96","184","47.826086956521740","52.1739130434782600","MULHER"
"251250705000008","1","165","131","296","55.743243243243240","44.2567567567567600","HOMEM"
"251250705000009","1","124","99","223","55.605381165919280","44.3946188340807200","HOMEM"
"251250705000010","1","154","132","286","53.846153846153850","46.1538461538461500","HOMEM"
"251250705000011","1","178","82","260","68.461538461538470","31.5384615384615400","HOMEM"
"251250705000012","1","246","130","376","65.425531914893610","34.5744680851063800","HOMEM"
"251250705000013","1","127","127","254","50.000000000000000","50.0000000000000000","IGUAL"
"251250705000014","1","135","52","187","72.192513368983950","27.8074866310160440","HOMEM"
"251250705000015","1","132","97","229","57.641921397379910","42.3580786026200900","HOMEM"
"251250705000016","1","144","114","258","55.813953488372090","44.1860465116279100","HOMEM"
"251250705000017","8","139","61","200","69.500000000000000","30.5000000000000000","HOMEM"
"251250705000018","8","148","36","184","80.434782608695660","19.5652173913043480","HOMEM"
"251250705000019","5","245","101","346","70.809248554913300","29.1907514450867040","HOMEM"
"251250705000020","5","65","10","75","86.666666666666670","13.3333333333333340","HOMEM"
"251250705000021","8","58","64","122","47.540983606557376","52.4590163934426240","MULHER"
"251250705000022","8","139","30","169","82.248520710059170","17.7514792899408300","HOMEM"
"251250705000023","8","139","18","157","88.535031847133750","11.4649681528662410","HOMEM"
"251250705000024","8","112","40","152","73.684210526315800","26.3157894736842100","HOMEM"
"251250705000025","8","70","38","108","64.814814814814810","35.1851851851851800","HOMEM"
"251250705000026","8","34","2","36","94.444444444444440","5.5555555555555550","HOMEM"
"251250705000027","8","35","7","42","83.333333333333330","16.6666666666666680","HOMEM"
"251250705000028","3","182","274","456","39.912280701754380","60.0877192982456200","MULHER"
"251250705000029","3","272","104","376","72.340425531914890","27.6595744680851080","HOMEM"
"251250705000030","3","238","96","334","71.257485029940110","28.7425149700598800","HOMEM"
"251250705000031","3","280","78","358","78.212290502793300","21.7877094972067060","HOMEM"
"251250705000032","5","121","39","160","75.625000000000000","24.3750000000000000","HOMEM"
"251250705000033","8","122","25","147","82.993197278911570","17.0068027210884340","HOMEM"
"251250705000034","8","84","27","111","75.675675675675680","24.3243243243243230","HOMEM"
"251250705000035","8","105","56","161","65.217391304347830","34.7826086956521700","HOMEM"
"251250705000036","8","48","163","211","22.748815165876778","77.2511848341232200","MULHER"
"251250705000037","8","122","58","180","67.777777777777770","32.2222222222222200","HOMEM"
"251250705000038","5","21","17","38","55.263157894736840","44.7368421052631600","HOMEM"
"251250705000039","8","119","23","142","83.802816901408450","16.1971830985915480","HOMEM"
"251250705000040","8","74","44","118","62.711864406779660","37.2881355932203400","HOMEM"
"251250705000041","8","210","51","261","80.459770114942530","19.5402298850574700","HOMEM"
"251250705000042","8","113","25","138","81.884057971014500","18.1159420289855080","HOMEM"
"251250705000043","8","26","8","34","76.470588235294120","23.5294117647058840","HOMEM"
"251250705000044","8","65","197","262","24.809160305343510","75.1908396946564900","MULHER"
"251250705000045","8","92","39","131","70.229007633587780","29.7709923664122120","HOMEM"
"251250705000046","8","68","23","91","74.725274725274730","25.2747252747252740","HOMEM"
"251250705000047","8","151","37","188","80.319148936170210","19.6808510638297880","HOMEM"
"251250705000048","8","123","73","196","62.755102040816325","37.2448979591836750","HOMEM"
"251250705000049","8","130","38","168","77.380952380952380","22.6190476190476200","HOMEM"
"251250705000050","8","99","31","130","76.153846153846160","23.8461538461538470","HOMEM"
"251250705000051","4","140","74","214","65.420560747663560","34.5794392523364500","HOMEM"
"251250705000052","4","118","61","179","65.921787709497210","34.0782122905027900","HOMEM"
"251250705000053","4","115","80","195","58.974358974358970","41.0256410256410300","HOMEM"
"251250705000054","1","55","118","173","31.791907514450866","68.2080924855491300","MULHER"
"251250705000055","1","57","104","161","35.403726708074540","64.5962732919254700","MULHER"
"251250705000056","1","50","142","192","26.041666666666668","73.9583333333333300","MULHER"
"251250705000057","1","59","111","170","34.705882352941174","65.2941176470588300","MULHER"
"251250705000058","4","70","16","86","81.395348837209300","18.6046511627907000","HOMEM"
"251250705000059","5","95","40","135","70.370370370370370","29.6296296296296300","HOMEM"
"251250705000060","5","106","33","139","76.258992805755400","23.7410071942446060","HOMEM"
"251250705000061","1","63","30","93","67.741935483870960","32.2580645161290300","HOMEM"
"251260605000001","1","121","54","175","69.142857142857140","30.8571428571428580","HOMEM"
"251260605000002","8","90","28","118","76.271186440677970","23.7288135593220350","HOMEM"
"251260605000003","8","77","60","137","56.204379562043800","43.7956204379562000","HOMEM"
"251270505000001","1","146","139","285","51.228070175438596","48.7719298245614040","HOMEM"
"251270505000002","1","115","128","243","47.325102880658434","52.6748971193415660","MULHER"
"251270505000003","1","49","168","217","22.580645161290324","77.4193548387096800","MULHER"
"251270505000004","1","87","97","184","47.282608695652170","52.7173913043478300","MULHER"
"251270505000005","1","114","171","285","40.000000000000000","60.0000000000000000","MULHER"
"251270505000006","1","129","83","212","60.849056603773580","39.1509433962264200","HOMEM"
"251270505000007","1","124","83","207","59.903381642512080","40.0966183574879200","HOMEM"
"251270505000008","1","105","55","160","65.625000000000000","34.3750000000000000","HOMEM"
"251270505000009","1","178","65","243","73.251028806584360","26.7489711934156400","HOMEM"
"251270505000010","8","47","12","59","79.661016949152540","20.3389830508474570","HOMEM"
"251270505000011","8","102","22","124","82.258064516129040","17.7419354838709680","HOMEM"
"251270505000012","8","116","30","146","79.452054794520550","20.5479452054794500","HOMEM"
"251270505000013","8","48","15","63","76.190476190476190","23.8095238095238100","HOMEM"
"251270505000014","8","78","30","108","72.222222222222230","27.7777777777777800","HOMEM"
"251270505000015","8","11","38","49","22.448979591836736","77.5510204081632700","MULHER"
"251270505000016","8","93","24","117","79.487179487179490","20.5128205128205150","HOMEM"
"251270505000017","8","62","25","87","71.264367816091950","28.7356321839080450","HOMEM"
"251270505000018","8","81","17","98","82.653061224489790","17.3469387755102030","HOMEM"
"251270505000019","8","149","67","216","68.981481481481480","31.0185185185185200","HOMEM"
"251270505000020","1","108","83","191","56.544502617801044","43.4554973821989560","HOMEM"
"251270505000021","1","94","70","164","57.317073170731710","42.6829268292682900","HOMEM"
"251270505000022","1","119","76","195","61.025641025641030","38.9743589743589700","HOMEM"
"251270505000023","1","182","68","250","72.800000000000000","27.2000000000000000","HOMEM"
"251270505000024","1","198","77","275","72.000000000000000","28.0000000000000000","HOMEM"
"251270505000025","1","148","65","213","69.483568075117380","30.5164319248826280","HOMEM"
"251270505000026","1","133","87","220","60.454545454545450","39.5454545454545500","HOMEM"
"251270505000027","1","170","111","281","60.498220640569390","39.5017793594306100","HOMEM"
"251270505000028","4","66","43","109","60.550458715596330","39.4495412844036700","HOMEM"
"251272105000001","1","146","73","219","66.666666666666670","33.3333333333333360","HOMEM"
"251272105000002","8","38","43","81","46.913580246913580","53.0864197530864200","MULHER"
"251272105000003","8","42","9","51","82.352941176470600","17.6470588235294130","HOMEM"
"251272105000004","8","40","19","59","67.796610169491530","32.2033898305084800","HOMEM"
"251272105000005","8","7","0","7","100.000000000000000","0.0000000000000000","HOMEM"
"251272105000006","8","187","48","235","79.574468085106390","20.4255319148936180","HOMEM"
"251272105000007","8","76","22","98","77.551020408163270","22.4489795918367360","HOMEM"
"251272105000008","1","150","70","220","68.181818181818190","31.8181818181818170","HOMEM"
"251272105000009","1","88","138","226","38.938053097345130","61.0619469026548700","MULHER"
"251272105000010","8","71","33","104","68.269230769230770","31.7307692307692300","HOMEM"
"251272105000011","8","141","48","189","74.603174603174610","25.3968253968253950","HOMEM"
"251272105000012","8","49","19","68","72.058823529411770","27.9411764705882360","HOMEM"
"251272105000013","5","126","41","167","75.449101796407190","24.5508982035928160","HOMEM"
"251274705000001","1","190","160","350","54.285714285714285","45.7142857142857150","HOMEM"
"251274705000002","1","164","100","264","62.121212121212125","37.8787878787878750","HOMEM"
"251274705000003","8","67","24","91","73.626373626373620","26.3736263736263720","HOMEM"
"251274705000004","8","130","23","153","84.967320261437900","15.0326797385620910","HOMEM"
"251274705000005","5","39","33","72","54.166666666666664","45.8333333333333360","HOMEM"
"251275405000001","1","75","108","183","40.983606557377050","59.0163934426229500","MULHER"
"251275405000002","1","61","208","269","22.676579925650557","77.3234200743494400","MULHER"
"251275405000003","1","191","148","339","56.342182890855455","43.6578171091445450","HOMEM"
"251275405000004","8","61","73","134","45.522388059701490","54.4776119402985100","MULHER"
"251275405000005","8","141","46","187","75.401069518716580","24.5989304812834200","HOMEM"
"251275405000006","8","34","15","49","69.387755102040810","30.6122448979591830","HOMEM"
"251275405000007","5","64","54","118","54.237288135593220","45.7627118644067800","HOMEM"
"251276205000001","1","152","78","230","66.086956521739130","33.9130434782608700","HOMEM"
"251276205000002","8","292","83","375","77.866666666666660","22.1333333333333330","HOMEM"
"251276205000003","8","81","37","118","68.644067796610170","31.3559322033898300","HOMEM"
"251276205000004","8","126","36","162","77.777777777777770","22.2222222222222200","HOMEM"
"251276205000005","5","55","6","61","90.163934426229500","9.8360655737704920","HOMEM"
"251276205000006","5","49","14","63","77.777777777777770","22.2222222222222200","HOMEM"
"251276205000007","1","98","56","154","63.636363636363630","36.3636363636363700","HOMEM"
"251276205000008","8","5","2","7","71.428571428571430","28.5714285714285730","HOMEM"
"251278805000001","1","61","100","161","37.888198757763970","62.1118012422360300","MULHER"
"251278805000002","8","101","45","146","69.178082191780820","30.8219178082191800","HOMEM"
"251278805000003","1","77","89","166","46.385542168674700","53.6144578313253000","MULHER"
"251280405000001","1","222","106","328","67.682926829268300","32.3170731707317100","HOMEM"
"251280405000002","1","186","58","244","76.229508196721310","23.7704918032786880","HOMEM"
"251280405000003","1","79","195","274","28.832116788321170","71.1678832116788300","MULHER"
"251280405000004","8","139","50","189","73.544973544973540","26.4550264550264560","HOMEM"
"251280405000005","8","68","108","176","38.636363636363630","61.3636363636363700","MULHER"
"251280405000006","8","73","15","88","82.954545454545450","17.0454545454545470","HOMEM"
"251280405000007","8","51","6","57","89.473684210526320","10.5263157894736850","HOMEM"
"251280405000008","8","23","40","63","36.507936507936506","63.4920634920634940","MULHER"
"251280405000009","8","157","41","198","79.292929292929290","20.7070707070707060","HOMEM"
"251280405000010","8","247","39","286","86.363636363636360","13.6363636363636370","HOMEM"
"251280405000011","8","67","17","84","79.761904761904760","20.2380952380952370","HOMEM"
"251280405000012","1","183","55","238","76.890756302521010","23.1092436974789900","HOMEM"
"251290305000001","1","176","121","297","59.259259259259260","40.7407407407407400","HOMEM"
"251290305000002","1","115","91","206","55.825242718446600","44.1747572815534000","HOMEM"
"251290305000003","1","111","83","194","57.216494845360830","42.7835051546391700","HOMEM"
"251290305000004","1","169","131","300","56.333333333333336","43.6666666666666640","HOMEM"
"251290305000005","1","204","126","330","61.818181818181820","38.1818181818181800","HOMEM"
"251290305000006","1","135","116","251","53.784860557768920","46.2151394422310800","HOMEM"
"251290305000007","1","185","169","354","52.259887005649716","47.7401129943502840","HOMEM"
"251290305000008","1","49","35","84","58.333333333333336","41.6666666666666640","HOMEM"
"251290305000009","1","152","109","261","58.237547892720310","41.7624521072796900","HOMEM"
"251290305000010","1","104","82","186","55.913978494623656","44.0860215053763440","HOMEM"
"251290305000011","1","145","150","295","49.152542372881356","50.8474576271186440","MULHER"
"251290305000012","8","0","0","0",NULL,NULL,NULL
"251290305000013","5","188","91","279","67.383512544802870","32.6164874551971300","HOMEM"
"251290305000014","8","51","13","64","79.687500000000000","20.3125000000000000","HOMEM"
"251290305000015","8","41","6","47","87.234042553191490","12.7659574468085100","HOMEM"
"251290305000016","8","24","44","68","35.294117647058826","64.7058823529411700","MULHER"
"251290305000017","8","35","99","134","26.119402985074625","73.8805970149253700","MULHER"
"251290305000018","8","212","49","261","81.226053639846740","18.7739463601532570","HOMEM"
"251290305000019","8","59","12","71","83.098591549295780","16.9014084507042240","HOMEM"
"251290305000020","5","123","75","198","62.121212121212125","37.8787878787878750","HOMEM"
"251290305000021","5","93","37","130","71.538461538461530","28.4615384615384600","HOMEM"
"251290305000022","5","99","40","139","71.223021582733810","28.7769784172661860","HOMEM"
"251290305000023","5","114","26","140","81.428571428571430","18.5714285714285730","HOMEM"
"251290305000024","8","0","0","0",NULL,NULL,NULL
"251290305000025","8","98","51","149","65.771812080536920","34.2281879194630900","HOMEM"
"251290305000026","8","0","0","0",NULL,NULL,NULL
"251290305000027","8","59","39","98","60.204081632653065","39.7959183673469350","HOMEM"
"251290305000029","8","179","107","286","62.587412587412590","37.4125874125874100","HOMEM"
"251290305000031","1","116","68","184","63.043478260869560","36.9565217391304400","HOMEM"
"251290305000032","1","181","100","281","64.412811387900360","35.5871886120996450","HOMEM"
"251290305000033","1","147","114","261","56.321839080459770","43.6781609195402300","HOMEM"
"251290305000034","1","60","37","97","61.855670103092784","38.1443298969072160","HOMEM"
"251290305000035","8","54","9","63","85.714285714285710","14.2857142857142860","HOMEM"
"251290305000036","5","62","29","91","68.131868131868130","31.8681318681318700","HOMEM"
"251290307000001","1","18","44","62","29.032258064516128","70.9677419354838700","MULHER"
"251290307000002","8","6","2","8","75.000000000000000","25.0000000000000000","HOMEM"
"251290307000003","8","45","21","66","68.181818181818190","31.8181818181818170","HOMEM"
"251290307000004","5","90","18","108","83.333333333333330","16.6666666666666680","HOMEM"
"251290307000005","5","55","11","66","83.333333333333330","16.6666666666666680","HOMEM"
"251290307000006","5","55","28","83","66.265060240963860","33.7349397590361450","HOMEM"
"251290320000001","1","193","80","273","70.695970695970700","29.3040293040293030","HOMEM"
"251290320000002","8","115","40","155","74.193548387096770","25.8064516129032240","HOMEM"
"251300005000001","1","83","93","176","47.159090909090910","52.8409090909090900","MULHER"
"251300005000002","8","6","0","6","100.000000000000000","0.0000000000000000","HOMEM"
"251300005000003","8","134","86","220","60.909090909090910","39.0909090909090900","HOMEM"
"251300005000004","8","149","115","264","56.439393939393940","43.5606060606060600","HOMEM"
"251300030000001","1","110","50","160","68.750000000000000","31.2500000000000000","HOMEM"
"251300030000002","8","43","25","68","63.235294117647060","36.7647058823529400","HOMEM"
"251300030000003","8","52","11","63","82.539682539682540","17.4603174603174600","HOMEM"
"251310905000001","1","159","119","278","57.194244604316545","42.8057553956834550","HOMEM"
"251310905000002","1","64","38","102","62.745098039215684","37.2549019607843160","HOMEM"
"251310905000003","1","140","99","239","58.577405857740590","41.4225941422594100","HOMEM"
"251310905000004","1","155","103","258","60.077519379844960","39.9224806201550400","HOMEM"
"251310905000005","8","136","41","177","76.836158192090400","23.1638418079096060","HOMEM"
"251310905000006","8","163","32","195","83.589743589743590","16.4102564102564100","HOMEM"
"251310905000007","8","108","22","130","83.076923076923080","16.9230769230769230","HOMEM"
"251310905000008","8","197","62","259","76.061776061776060","23.9382239382239400","HOMEM"
"251310905000009","8","94","33","127","74.015748031496060","25.9842519685039370","HOMEM"
"251310905000010","8","56","40","96","58.333333333333336","41.6666666666666640","HOMEM"
"251310905000011","1","180","100","280","64.285714285714290","35.7142857142857150","HOMEM"
"251310905000012","5","42","11","53","79.245283018867920","20.7547169811320770","HOMEM"
"251310907000001","1","175","107","282","62.056737588652480","37.9432624113475200","HOMEM"
"251310907000002","5","65","23","88","73.863636363636360","26.1363636363636370","HOMEM"
"251310907000003","8","121","45","166","72.891566265060230","27.1084337349397600","HOMEM"
"251310907000004","8","74","40","114","64.912280701754380","35.0877192982456200","HOMEM"
"251310907000005","8","55","16","71","77.464788732394370","22.5352112676056320","HOMEM"
"251310908000001","1","74","91","165","44.848484848484850","55.1515151515151500","MULHER"
"251310908000002","8","233","104","337","69.139465875370920","30.8605341246290800","HOMEM"
"251310908000003","8","90","25","115","78.260869565217390","21.7391304347826100","HOMEM"
"251315805000001","1","58","230","288","20.138888888888890","79.8611111111111100","MULHER"
"251315805000002","8","139","42","181","76.795580110497240","23.2044198895027630","HOMEM"
"251315805000003","8","131","64","195","67.179487179487180","32.8205128205128200","HOMEM"
"251315805000004","8","95","58","153","62.091503267973856","37.9084967320261440","HOMEM"
"251315805000005","8","16","102","118","13.559322033898304","86.4406779661016900","MULHER"
"251315805000006","8","89","21","110","80.909090909090900","19.0909090909090900","HOMEM"
"251315805000007","8","74","198","272","27.205882352941178","72.7941176470588300","MULHER"
"251315805000008","8","44","104","148","29.729729729729730","70.2702702702702700","MULHER"
"251315805000009","1","92","160","252","36.507936507936506","63.4920634920634940","MULHER"
"251315805000010","5","55","36","91","60.439560439560440","39.5604395604395600","HOMEM"
"251320805000001","1","167","125","292","57.191780821917810","42.8082191780821900","HOMEM"
"251320805000002","1","140","59","199","70.351758793969850","29.6482412060301500","HOMEM"
"251320805000003","8","53","7","60","88.333333333333330","11.6666666666666660","HOMEM"
"251320805000004","8","130","18","148","87.837837837837840","12.1621621621621610","HOMEM"
"251320805000005","8","150","42","192","78.125000000000000","21.8750000000000000","HOMEM"
"251320805000006","5","122","35","157","77.707006369426750","22.2929936305732500","HOMEM"
"251320805000007","8","25","3","28","89.285714285714290","10.7142857142857140","HOMEM"
"251320805000008","5","164","57","221","74.208144796380100","25.7918552036199100","HOMEM"
"251320805000009","8","165","27","192","85.937500000000000","14.0625000000000000","HOMEM"
"251320805000010","1","126","51","177","71.186440677966100","28.8135593220339000","HOMEM"
"251320805000011","1","158","70","228","69.298245614035080","30.7017543859649100","HOMEM"
"251330705000001","1","85","52","137","62.043795620437955","37.9562043795620450","HOMEM"
"251330705000002","1","165","78","243","67.901234567901240","32.0987654320987660","HOMEM"
"251330705000003","1","230","83","313","73.482428115015980","26.5175718849840260","HOMEM"
"251330705000004","8","60","19","79","75.949367088607600","24.0506329113924050","HOMEM"
"251330705000005","8","56","94","150","37.333333333333336","62.6666666666666640","MULHER"
"251330705000006","8","146","17","163","89.570552147239270","10.4294478527607360","HOMEM"
"251330705000007","8","89","25","114","78.070175438596500","21.9298245614035100","HOMEM"
"251330705000008","5","39","65","104","37.500000000000000","62.5000000000000000","MULHER"
"251330705000009","8","121","33","154","78.571428571428570","21.4285714285714270","HOMEM"
"251330705000010","1","133","74","207","64.251207729468600","35.7487922705314000","HOMEM"
"251335605000001","1","184","210","394","46.700507614213200","53.2994923857868000","MULHER"
"251335605000002","8","88","17","105","83.809523809523810","16.1904761904761900","HOMEM"
"251335605000003","8","82","53","135","60.740740740740740","39.2592592592592600","HOMEM"
"251335605000004","8","52","53","105","49.523809523809526","50.4761904761904740","MULHER"
"251335605000005","8","64","37","101","63.366336633663366","36.6336633663366340","HOMEM"
"251335605000006","8","68","14","82","82.926829268292680","17.0731707317073180","HOMEM"
"251340605000001","1","98","83","181","54.143646408839780","45.8563535911602200","HOMEM"
"251340605000002","1","117","109","226","51.769911504424776","48.2300884955752240","HOMEM"
"251340605000003","1","153","59","212","72.169811320754720","27.8301886792452820","HOMEM"
"251340605000004","1","181","124","305","59.344262295081970","40.6557377049180300","HOMEM"
"251340605000005","1","79","129","208","37.980769230769230","62.0192307692307700","MULHER"
"251340605000006","1","82","77","159","51.572327044025160","48.4276729559748400","HOMEM"
"251340605000007","1","196","74","270","72.592592592592600","27.4074074074074100","HOMEM"
"251340605000008","1","94","112","206","45.631067961165050","54.3689320388349500","MULHER"
"251340605000009","1","89","115","204","43.627450980392155","56.3725490196078450","MULHER"
"251340605000010","1","124","87","211","58.767772511848340","41.2322274881516600","HOMEM"
"251340605000012","1","150","82","232","64.655172413793110","35.3448275862069000","HOMEM"
"251340605000013","1","98","87","185","52.972972972972975","47.0270270270270250","HOMEM"
"251340605000014","1","272","69","341","79.765395894428150","20.2346041055718470","HOMEM"
"251340605000015","8","43","11","54","79.629629629629630","20.3703703703703700","HOMEM"
"251340605000016","8","80","8","88","90.909090909090900","9.0909090909090920","HOMEM"
"251340605000017","8","77","8","85","90.588235294117650","9.4117647058823530","HOMEM"
"251340605000018","8","39","2","41","95.121951219512200","4.8780487804878050","HOMEM"
"251340605000019","8","27","12","39","69.230769230769230","30.7692307692307700","HOMEM"
"251340605000020","8","26","2","28","92.857142857142860","7.1428571428571430","HOMEM"
"251340605000021","8","6","2","8","75.000000000000000","25.0000000000000000","HOMEM"
"251340605000022","1","38","34","72","52.777777777777780","47.2222222222222200","HOMEM"
"251340605000023","1","139","81","220","63.181818181818180","36.8181818181818200","HOMEM"
"251340605000024","1","102","94","196","52.040816326530610","47.9591836734693900","HOMEM"
"251340605000025","1","59","46","105","56.190476190476190","43.8095238095238100","HOMEM"
"251340605000026","1","135","47","182","74.175824175824180","25.8241758241758250","HOMEM"
"251340605000027","1","193","102","295","65.423728813559320","34.5762711864406800","HOMEM"
"251350505000001","1","191","115","306","62.418300653594770","37.5816993464052300","HOMEM"
"251350505000002","1","86","46","132","65.151515151515160","34.8484848484848500","HOMEM"
"251350505000003","8","17","2","19","89.473684210526320","10.5263157894736850","HOMEM"
"251350505000004","8","87","9","96","90.625000000000000","9.3750000000000000","HOMEM"
"251350505000005","8","172","19","191","90.052356020942410","9.9476439790575920","HOMEM"
"251350505000006","8","175","27","202","86.633663366336630","13.3663366336633660","HOMEM"
"251350505000007","8","54","8","62","87.096774193548380","12.9032258064516120","HOMEM"
"251350505000008","8","135","20","155","87.096774193548380","12.9032258064516120","HOMEM"
"251350505000009","8","18","3","21","85.714285714285710","14.2857142857142860","HOMEM"
"251350505000010","1","136","90","226","60.176991150442475","39.8230088495575250","HOMEM"
"251360405000001","1","184","98","282","65.248226950354600","34.7517730496453940","HOMEM"
"251360405000002","1","194","116","310","62.580645161290320","37.4193548387096800","HOMEM"
"251360405000003","1","143","80","223","64.125560538116590","35.8744394618834050","HOMEM"
"251360405000004","8","34","3","37","91.891891891891890","8.1081081081081090","HOMEM"
"251360405000005","8","51","22","73","69.863013698630140","30.1369863013698630","HOMEM"
"251360405000006","8","207","45","252","82.142857142857140","17.8571428571428580","HOMEM"
"251360405000007","8","131","18","149","87.919463087248320","12.0805369127516770","HOMEM"
"251360405000008","5","52","15","67","77.611940298507460","22.3880597014925370","HOMEM"
"251360405000009","1","108","43","151","71.523178807947020","28.4768211920529800","HOMEM"
"251360420000001","1","95","49","144","65.972222222222230","34.0277777777777800","HOMEM"
"251360420000002","8","137","19","156","87.820512820512820","12.1794871794871790","HOMEM"
"251360420000003","8","139","20","159","87.421383647798750","12.5786163522012590","HOMEM"
"251365305000001","1","174","58","232","75.000000000000000","25.0000000000000000","HOMEM"
"251365305000002","5","65","26","91","71.428571428571430","28.5714285714285730","HOMEM"
"251365305000003","5","71","51","122","58.196721311475410","41.8032786885245900","HOMEM"
"251365305000004","8","108","22","130","83.076923076923080","16.9230769230769230","HOMEM"
"251365305000005","8","142","33","175","81.142857142857140","18.8571428571428580","HOMEM"
"251370305000001","1","129","26","155","83.225806451612900","16.7741935483870960","HOMEM"
"251370305000002","1","106","66","172","61.627906976744185","38.3720930232558150","HOMEM"
"251370305000003","1","176","75","251","70.119521912350590","29.8804780876494000","HOMEM"
"251370305000004","1","119","78","197","60.406091370558380","39.5939086294416200","HOMEM"
"251370305000005","1","170","74","244","69.672131147540980","30.3278688524590160","HOMEM"
"251370305000006","1","155","66","221","70.135746606334850","29.8642533936651600","HOMEM"
"251370305000007","1","171","78","249","68.674698795180720","31.3253012048192760","HOMEM"
"251370305000008","1","114","82","196","58.163265306122450","41.8367346938775500","HOMEM"
"251370305000009","1","62","287","349","17.765042979942690","82.2349570200573100","MULHER"
"251370305000010","1","141","101","242","58.264462809917354","41.7355371900826460","HOMEM"
"251370305000011","1","50","36","86","58.139534883720930","41.8604651162790700","HOMEM"
"251370305000012","1","188","114","302","62.251655629139070","37.7483443708609300","HOMEM"
"251370305000013","1","81","81","162","50.000000000000000","50.0000000000000000","IGUAL"
"251370305000014","1","157","75","232","67.672413793103440","32.3275862068965550","HOMEM"
"251370305000015","1","155","115","270","57.407407407407405","42.5925925925925950","HOMEM"
"251370305000016","1","132","79","211","62.559241706161140","37.4407582938388600","HOMEM"
"251370305000017","1","177","119","296","59.797297297297300","40.2027027027027000","HOMEM"
"251370305000018","1","144","99","243","59.259259259259260","40.7407407407407400","HOMEM"
"251370305000019","1","92","74","166","55.421686746987950","44.5783132530120500","HOMEM"
"251370305000020","1","145","105","250","58.000000000000000","42.0000000000000000","HOMEM"
"251370305000021","1","82","97","179","45.810055865921790","54.1899441340782100","MULHER"
"251370305000022","1","59","47","106","55.660377358490564","44.3396226415094360","HOMEM"
"251370305000023","1","184","168","352","52.272727272727270","47.7272727272727300","HOMEM"
"251370305000024","1","130","91","221","58.823529411764700","41.1764705882353000","HOMEM"
"251370305000025","1","124","91","215","57.674418604651166","42.3255813953488340","HOMEM"
"251370305000026","1","149","72","221","67.420814479638010","32.5791855203619900","HOMEM"
"251370305000027","1","168","64","232","72.413793103448270","27.5862068965517220","HOMEM"
"251370305000028","1","196","78","274","71.532846715328460","28.4671532846715320","HOMEM"
"251370305000029","1","154","149","303","50.825082508250820","49.1749174917491800","HOMEM"
"251370305000030","1","110","48","158","69.620253164556960","30.3797468354430360","HOMEM"
"251370305000031","1","85","211","296","28.716216216216218","71.2837837837837900","MULHER"
"251370305000032","1","47","24","71","66.197183098591550","33.8028169014084500","HOMEM"
"251370305000033","1","193","102","295","65.423728813559320","34.5762711864406800","HOMEM"
"251370305000034","1","150","111","261","57.471264367816090","42.5287356321839100","HOMEM"
"251370305000035","1","161","122","283","56.890459363957596","43.1095406360424040","HOMEM"
"251370305000036","1","88","58","146","60.273972602739725","39.7260273972602750","HOMEM"
"251370305000037","1","161","63","224","71.875000000000000","28.1250000000000000","HOMEM"
"251370305000038","1","149","70","219","68.036529680365290","31.9634703196347020","HOMEM"
"251370305000039","1","172","102","274","62.773722627737230","37.2262773722627700","HOMEM"
"251370305000040","1","116","62","178","65.168539325842700","34.8314606741573060","HOMEM"
"251370305000041","1","65","64","129","50.387596899224800","49.6124031007752000","HOMEM"
"251370305000042","1","142","113","255","55.686274509803920","44.3137254901960800","HOMEM"
"251370305000043","1","143","137","280","51.071428571428570","48.9285714285714300","HOMEM"
"251370305000044","1","175","113","288","60.763888888888886","39.2361111111111140","HOMEM"
"251370305000045","1","193","142","335","57.611940298507460","42.3880597014925400","HOMEM"
"251370305000046","1","193","161","354","54.519774011299430","45.4802259887005700","HOMEM"
"251370305000047","1","167","87","254","65.748031496062990","34.2519685039370100","HOMEM"
"251370305000048","1","106","115","221","47.963800904977376","52.0361990950226240","MULHER"
"251370305000049","1","131","63","194","67.525773195876280","32.4742268041237100","HOMEM"
"251370305000050","1","218","91","309","70.550161812297730","29.4498381877022660","HOMEM"
"251370305000051","1","90","111","201","44.776119402985074","55.2238805970149260","MULHER"
"251370305000052","1","55","73","128","42.968750000000000","57.0312500000000000","MULHER"
"251370305000053","1","215","102","317","67.823343848580440","32.1766561514195600","HOMEM"
"251370305000054","1","136","72","208","65.384615384615390","34.6153846153846100","HOMEM"
"251370305000055","1","95","60","155","61.290322580645160","38.7096774193548400","HOMEM"
"251370305000056","1","172","101","273","63.003663003663010","36.9963369963369900","HOMEM"
"251370305000057","1","206","188","394","52.284263959390860","47.7157360406091400","HOMEM"
"251370305000058","1","97","85","182","53.296703296703300","46.7032967032967000","HOMEM"
"251370305000059","1","79","55","134","58.955223880597020","41.0447761194029800","HOMEM"
"251370305000060","1","101","108","209","48.325358851674640","51.6746411483253600","MULHER"
"251370305000061","1","63","50","113","55.752212389380530","44.2477876106194700","HOMEM"
"251370305000062","1","148","109","257","57.587548638132300","42.4124513618677000","HOMEM"
"251370305000063","1","93","110","203","45.812807881773400","54.1871921182266000","MULHER"
"251370305000064","1","92","82","174","52.873563218390810","47.1264367816091900","HOMEM"
"251370305000065","1","145","139","284","51.056338028169016","48.9436619718309840","HOMEM"
"251370305000066","1","76","121","197","38.578680203045685","61.4213197969543150","MULHER"
"251370305000067","1","84","134","218","38.532110091743120","61.4678899082568800","MULHER"
"251370305000068","1","138","177","315","43.809523809523810","56.1904761904761900","MULHER"
"251370305000069","1","125","65","190","65.789473684210520","34.2105263157894700","HOMEM"
"251370305000070","1","88","81","169","52.071005917159766","47.9289940828402340","HOMEM"
"251370305000071","1","125","63","188","66.489361702127650","33.5106382978723400","HOMEM"
"251370305000072","1","169","130","299","56.521739130434780","43.4782608695652200","HOMEM"
"251370305000073","1","144","123","267","53.932584269662920","46.0674157303370800","HOMEM"
"251370305000074","1","148","138","286","51.748251748251750","48.2517482517482500","HOMEM"
"251370305000075","1","111","116","227","48.898678414096910","51.1013215859030900","MULHER"
"251370305000076","1","104","98","202","51.485148514851490","48.5148514851485100","HOMEM"
"251370305000077","1","200","127","327","61.162079510703364","38.8379204892966360","HOMEM"
"251370305000078","1","113","77","190","59.473684210526315","40.5263157894736850","HOMEM"
"251370305000079","1","156","116","272","57.352941176470590","42.6470588235294100","HOMEM"
"251370305000080","1","195","139","334","58.383233532934135","41.6167664670658650","HOMEM"
"251370305000081","1","147","94","241","60.995850622406635","39.0041493775933650","HOMEM"
"251370305000082","1","147","133","280","52.500000000000000","47.5000000000000000","HOMEM"
"251370305000083","1","101","70","171","59.064327485380120","40.9356725146198800","HOMEM"
"251370305000084","1","182","142","324","56.172839506172840","43.8271604938271600","HOMEM"
"251370305000085","1","122","184","306","39.869281045751634","60.1307189542483660","MULHER"
"251370305000086","1","4","1","5","80.000000000000000","20.0000000000000000","HOMEM"
"251370305000087","1","180","110","290","62.068965517241380","37.9310344827586200","HOMEM"
"251370305000088","1","141","68","209","67.464114832535880","32.5358851674641160","HOMEM"
"251370305000089","1","131","97","228","57.456140350877190","42.5438596491228100","HOMEM"
"251370305000090","1","87","73","160","54.375000000000000","45.6250000000000000","HOMEM"
"251370305000091","1","17","7","24","70.833333333333330","29.1666666666666680","HOMEM"
"251370305000092","1","92","111","203","45.320197044334975","54.6798029556650250","MULHER"
"251370305000093","8","95","8","103","92.233009708737870","7.7669902912621360","HOMEM"
"251370305000094","8","69","40","109","63.302752293577980","36.6972477064220200","HOMEM"
"251370305000095","8","110","30","140","78.571428571428570","21.4285714285714270","HOMEM"
"251370305000096","8","73","29","102","71.568627450980390","28.4313725490196060","HOMEM"
"251370305000097","8","36","48","84","42.857142857142854","57.1428571428571460","MULHER"
"251370305000098","8","16","19","35","45.714285714285715","54.2857142857142850","MULHER"
"251370305000099","5","28","76","104","26.923076923076923","73.0769230769230800","MULHER"
"251370305000100","5","130","65","195","66.666666666666670","33.3333333333333360","HOMEM"
"251370305000101","8","110","18","128","85.937500000000000","14.0625000000000000","HOMEM"
"251370305000102","8","100","19","119","84.033613445378150","15.9663865546218490","HOMEM"
"251370305000103","8","10","3","13","76.923076923076920","23.0769230769230770","HOMEM"
"251370305000104","8","20","5","25","80.000000000000000","20.0000000000000000","HOMEM"
"251370305000105","5","143","48","191","74.869109947643980","25.1308900523560230","HOMEM"
"251370305000106","1","193","68","261","73.946360153256700","26.0536398467432950","HOMEM"
"251370305000107","1","146","56","202","72.277227722772280","27.7227722772277230","HOMEM"
"251370305000108","1","112","108","220","50.909090909090910","49.0909090909090900","HOMEM"
"251370305000109","1","66","50","116","56.896551724137930","43.1034482758620700","HOMEM"
"251370305000110","1","104","73","177","58.757062146892660","41.2429378531073400","HOMEM"
"251370305000111","1","148","66","214","69.158878504672900","30.8411214953271000","HOMEM"
"251370305000112","1","73","93","166","43.975903614457835","56.0240963855421650","MULHER"
"251370305000113","1","98","162","260","37.692307692307690","62.3076923076923100","MULHER"
"251370305000114","1","44","134","178","24.719101123595507","75.2808988764044900","MULHER"
"251370305000115","1","116","46","162","71.604938271604940","28.3950617283950630","HOMEM"
"251370305000116","1","103","42","145","71.034482758620680","28.9655172413793100","HOMEM"
"251370305000117","1","135","93","228","59.210526315789470","40.7894736842105300","HOMEM"
"251370305000118","1","142","140","282","50.354609929078016","49.6453900709219840","HOMEM"
"251370305000119","1","118","49","167","70.658682634730540","29.3413173652694600","HOMEM"
"251370305000120","1","116","63","179","64.804469273743010","35.1955307262569800","HOMEM"
"251370305000121","1","206","82","288","71.527777777777770","28.4722222222222200","HOMEM"
"251370305000122","1","111","79","190","58.421052631578945","41.5789473684210550","HOMEM"
"251370305000123","1","167","87","254","65.748031496062990","34.2519685039370100","HOMEM"
"251370305000124","1","97","72","169","57.396449704142015","42.6035502958579850","HOMEM"
"251370305000125","1","128","63","191","67.015706806282720","32.9842931937172800","HOMEM"
"251370305000126","1","287","79","366","78.415300546448100","21.5846994535519130","HOMEM"
"251370305000127","1","101","73","174","58.045977011494250","41.9540229885057500","HOMEM"
"251370305000128","1","113","90","203","55.665024630541870","44.3349753694581300","HOMEM"
"251370305000129","1","219","88","307","71.335504885993490","28.6644951140065130","HOMEM"
"251370305000130","1","190","103","293","64.846416382252560","35.1535836177474440","HOMEM"
"251370305000131","1","218","140","358","60.893854748603350","39.1061452513966500","HOMEM"
"251370305000132","1","151","61","212","71.226415094339630","28.7735849056603800","HOMEM"
"251370305000133","1","146","60","206","70.873786407766990","29.1262135922330100","HOMEM"
"251370305000134","1","99","68","167","59.281437125748500","40.7185628742515000","HOMEM"
"251370305000135","1","68","67","135","50.370370370370374","49.6296296296296260","HOMEM"
"251370305000136","1","80","73","153","52.287581699346404","47.7124183006535960","HOMEM"
"251370305000137","1","189","58","247","76.518218623481790","23.4817813765182170","HOMEM"
"251370305000138","1","68","97","165","41.212121212121210","58.7878787878787900","MULHER"
"251370305000139","1","148","75","223","66.367713004484300","33.6322869955156900","HOMEM"
"251370305000140","1","82","64","146","56.164383561643840","43.8356164383561600","HOMEM"
"251370305000141","1","80","84","164","48.780487804878050","51.2195121951219500","MULHER"
"251370305000142","5","138","49","187","73.796791443850270","26.2032085561497330","HOMEM"
"251370305000143","5","87","51","138","63.043478260869560","36.9565217391304400","HOMEM"
"251370305000144","5","119","31","150","79.333333333333330","20.6666666666666680","HOMEM"
"251370305000145","5","88","44","132","66.666666666666670","33.3333333333333360","HOMEM"
"251370310000001","1","178","88","266","66.917293233082700","33.0827067669172900","HOMEM"
"251370310000002","1","262","75","337","77.744807121661720","22.2551928783382780","HOMEM"
"251370310000003","8","51","25","76","67.105263157894740","32.8947368421052600","HOMEM"
"251370310000004","5","69","32","101","68.316831683168320","31.6831683168316830","HOMEM"
"251370310000005","5","86","55","141","60.992907801418440","39.0070921985815600","HOMEM"
"251370310000006","8","17","11","28","60.714285714285715","39.2857142857142850","HOMEM"
"251370310000007","8","42","12","54","77.777777777777770","22.2222222222222200","HOMEM"
"251370310000008","8","78","17","95","82.105263157894740","17.8947368421052640","HOMEM"
"251370310000009","8","72","7","79","91.139240506329120","8.8607594936708850","HOMEM"
"251370310000010","5","95","50","145","65.517241379310350","34.4827586206896600","HOMEM"
"251370310000011","5","131","41","172","76.162790697674420","23.8372093023255830","HOMEM"
"251370310000012","5","142","44","186","76.344086021505380","23.6559139784946240","HOMEM"
"251370310000013","5","128","49","177","72.316384180790960","27.6836158192090380","HOMEM"
"251370310000014","8","130","37","167","77.844311377245500","22.1556886227544900","HOMEM"
"251370310000015","5","107","74","181","59.116022099447510","40.8839779005524900","HOMEM"
"251370310000016","5","130","33","163","79.754601226993870","20.2453987730061340","HOMEM"
"251370310000017","5","94","67","161","58.385093167701860","41.6149068322981400","HOMEM"
"251370310000018","5","131","49","180","72.777777777777770","27.2222222222222200","HOMEM"
"251370310000019","5","150","43","193","77.720207253886020","22.2797927461139900","HOMEM"
"251370310000020","5","87","59","146","59.589041095890410","40.4109589041095900","HOMEM"
"251380205000001","1","154","87","241","63.900414937759340","36.0995850622406600","HOMEM"
"251380205000002","8","118","13","131","90.076335877862590","9.9236641221374050","HOMEM"
"251380205000003","8","115","13","128","89.843750000000000","10.1562500000000000","HOMEM"
"251380205000004","8","94","15","109","86.238532110091740","13.7614678899082570","HOMEM"
"251380205000005","8","45","3","48","93.750000000000000","6.2500000000000000","HOMEM"
"251380205000006","8","34","6","40","85.000000000000000","15.0000000000000000","HOMEM"
"251380205000007","8","65","10","75","86.666666666666670","13.3333333333333340","HOMEM"
"251380205000008","8","51","34","85","60.000000000000000","40.0000000000000000","HOMEM"
"251380205000009","1","265","142","407","65.110565110565100","34.8894348894348900","HOMEM"
"251385105000001","1","148","121","269","55.018587360594790","44.9814126394052100","HOMEM"
"251385105000002","8","80","73","153","52.287581699346404","47.7124183006535960","HOMEM"
"251385105000003","8","119","114","233","51.072961373390555","48.9270386266094450","HOMEM"
"251385105000004","8","91","48","139","65.467625899280580","34.5323741007194200","HOMEM"
"251390105000001","1","76","90","166","45.783132530120480","54.2168674698795200","MULHER"
"251390105000002","1","95","201","296","32.094594594594600","67.9054054054054000","MULHER"
"251390105000003","1","86","75","161","53.416149068322980","46.5838509316770200","HOMEM"
"251390105000004","1","209","163","372","56.182795698924730","43.8172043010752700","HOMEM"
"251390105000005","1","210","110","320","65.625000000000000","34.3750000000000000","HOMEM"
"251390105000006","1","117","90","207","56.521739130434780","43.4782608695652200","HOMEM"
"251390105000007","1","173","80","253","68.379446640316200","31.6205533596837930","HOMEM"
"251390105000008","1","181","93","274","66.058394160583940","33.9416058394160560","HOMEM"
"251390105000009","1","222","137","359","61.838440111420610","38.1615598885793900","HOMEM"
"251390105000010","1","187","124","311","60.128617363344050","39.8713826366559500","HOMEM"
"251390105000011","1","67","156","223","30.044843049327355","69.9551569506726500","MULHER"
"251390105000012","1","89","64","153","58.169934640522875","41.8300653594771250","HOMEM"
"251390105000013","1","110","76","186","59.139784946236560","40.8602150537634400","HOMEM"
"251390105000014","1","306","105","411","74.452554744525540","25.5474452554744540","HOMEM"
"251390105000015","1","108","46","154","70.129870129870130","29.8701298701298700","HOMEM"
"251390105000016","1","182","90","272","66.911764705882350","33.0882352941176450","HOMEM"
"251390105000017","1","158","152","310","50.967741935483870","49.0322580645161300","HOMEM"
"251390105000018","1","107","61","168","63.690476190476190","36.3095238095238100","HOMEM"
"251390105000019","8","165","33","198","83.333333333333330","16.6666666666666680","HOMEM"
"251390105000020","8","118","97","215","54.883720930232556","45.1162790697674440","HOMEM"
"251390105000021","8","77","16","93","82.795698924731180","17.2043010752688160","HOMEM"
"251390105000022","8","117","43","160","73.125000000000000","26.8750000000000000","HOMEM"
"251390105000023","8","21","10","31","67.741935483870960","32.2580645161290300","HOMEM"
"251390105000024","8","225","71","296","76.013513513513520","23.9864864864864880","HOMEM"
"251390105000025","8","170","29","199","85.427135678391960","14.5728643216080400","HOMEM"
"251390105000026","1","156","66","222","70.270270270270270","29.7297297297297300","HOMEM"
"251390105000027","1","262","86","348","75.287356321839080","24.7126436781609200","HOMEM"
"251390105000028","1","161","52","213","75.586854460093900","24.4131455399061040","HOMEM"
"251390105000029","1","187","89","276","67.753623188405800","32.2463768115942000","HOMEM"
"251390105000030","1","70","127","197","35.532994923857870","64.4670050761421300","MULHER"
"251390105000031","1","72","94","166","43.373493975903614","56.6265060240963860","MULHER"
"251390105000032","1","164","71","235","69.787234042553200","30.2127659574468100","HOMEM"
"251390105000033","1","171","76","247","69.230769230769230","30.7692307692307700","HOMEM"
"251390105000034","1","140","68","208","67.307692307692300","32.6923076923076900","HOMEM"
"251390105000035","1","141","61","202","69.801980198019800","30.1980198019801980","HOMEM"
"251390105000036","5","69","34","103","66.990291262135930","33.0097087378640800","HOMEM"
"251390105000037","5","36","23","59","61.016949152542374","38.9830508474576260","HOMEM"
"251390105000038","5","146","37","183","79.781420765027320","20.2185792349726760","HOMEM"
"251392705000001","1","137","42","179","76.536312849162020","23.4636871508379880","HOMEM"
"251392705000002","1","128","80","208","61.538461538461540","38.4615384615384600","HOMEM"
"251392705000003","8","40","4","44","90.909090909090900","9.0909090909090920","HOMEM"
"251392705000004","8","85","9","94","90.425531914893610","9.5744680851063840","HOMEM"
"251392705000005","8","36","3","39","92.307692307692300","7.6923076923076925","HOMEM"
"251392705000006","8","129","36","165","78.181818181818190","21.8181818181818170","HOMEM"
"251392705000007","5","27","8","35","77.142857142857140","22.8571428571428580","HOMEM"
"251392705000008","1","130","61","191","68.062827225130890","31.9371727748691100","HOMEM"
"251392705000009","1","167","77","244","68.442622950819670","31.5573770491803280","HOMEM"
"251394305000001","1","111","48","159","69.811320754716990","30.1886792452830200","HOMEM"
"251394305000002","8","125","61","186","67.204301075268820","32.7956989247311840","HOMEM"
"251394305000003","8","115","41","156","73.717948717948720","26.2820512820512800","HOMEM"
"251394305000004","1","102","66","168","60.714285714285715","39.2857142857142850","HOMEM"
"251394305000005","4","31","17","48","64.583333333333330","35.4166666666666640","HOMEM"
"251396805000001","1","195","103","298","65.436241610738250","34.5637583892617400","HOMEM"
"251396805000002","8","26","34","60","43.333333333333336","56.6666666666666640","MULHER"
"251396805000003","8","31","39","70","44.285714285714285","55.7142857142857150","MULHER"
"251396805000004","8","10","12","22","45.454545454545450","54.5454545454545500","MULHER"
"251396805000005","8","105","57","162","64.814814814814810","35.1851851851851800","HOMEM"
"251396805000006","8","165","48","213","77.464788732394370","22.5352112676056320","HOMEM"
"251398405000001","1","249","144","393","63.358778625954200","36.6412213740458000","HOMEM"
"251398405000002","8","109","21","130","83.846153846153840","16.1538461538461530","HOMEM"
"251398405000003","8","154","33","187","82.352941176470600","17.6470588235294130","HOMEM"
"251398405000004","8","109","26","135","80.740740740740750","19.2592592592592600","HOMEM"
"251398405000005","5","138","21","159","86.792452830188680","13.2075471698113200","HOMEM"
"251400805000001","1","70","74","144","48.611111111111114","51.3888888888888860","MULHER"
"251400805000002","1","137","63","200","68.500000000000000","31.5000000000000000","HOMEM"
"251400805000003","1","120","82","202","59.405940594059410","40.5940594059405900","HOMEM"
"251400805000004","8","94","32","126","74.603174603174610","25.3968253968253950","HOMEM"
"251400805000005","8","95","54","149","63.758389261744966","36.2416107382550340","HOMEM"
"251400805000006","8","128","42","170","75.294117647058830","24.7058823529411780","HOMEM"
"251400805000007","8","21","12","33","63.636363636363630","36.3636363636363700","HOMEM"
"251400805000008","1","45","142","187","24.064171122994650","75.9358288770053500","MULHER"
"251400805000009","5","27","78","105","25.714285714285715","74.2857142857142900","MULHER"
"251410705000001","1","68","214","282","24.113475177304963","75.8865248226950400","MULHER"
"251410705000002","8","72","12","84","85.714285714285710","14.2857142857142860","HOMEM"
"251410705000003","8","54","73","127","42.519685039370080","57.4803149606299200","MULHER"
"251410705000004","8","99","35","134","73.880597014925370","26.1194029850746250","HOMEM"
"251410705000005","1","110","57","167","65.868263473053890","34.1317365269461060","HOMEM"
"251410710000001","1","43","32","75","57.333333333333336","42.6666666666666640","HOMEM"
"251410710000002","8","30","43","73","41.095890410958900","58.9041095890411000","MULHER"
"251410710000003","8","122","35","157","77.707006369426750","22.2929936305732500","HOMEM"
"251410710000004","8","23","6","29","79.310344827586200","20.6896551724137940","HOMEM"
"251410710000005","8","120","46","166","72.289156626506030","27.7108433734939760","HOMEM"
"251410710000006","5","78","73","151","51.655629139072850","48.3443708609271500","HOMEM"
"251420605000001","1","191","108","299","63.879598662207360","36.1204013377926400","HOMEM"
"251420605000002","1","71","200","271","26.199261992619927","73.8007380073800800","MULHER"
"251420605000003","8","287","51","338","84.911242603550290","15.0887573964497040","HOMEM"
"251420605000004","8","176","11","187","94.117647058823540","5.8823529411764710","HOMEM"
"251420605000005","8","243","44","287","84.668989547038320","15.3310104529616730","HOMEM"
"251420605000006","8","76","11","87","87.356321839080460","12.6436781609195400","HOMEM"
"251420605000007","8","250","71","321","77.881619937694710","22.1183800623052950","HOMEM"
"251420605000008","1","109","48","157","69.426751592356700","30.5732484076433120","HOMEM"
"251420605000009","1","203","71","274","74.087591240875910","25.9124087591240870","HOMEM"
"251430505000001","1","146","89","235","62.127659574468080","37.8723404255319200","HOMEM"
"251430505000002","1","203","73","276","73.550724637681160","26.4492753623188400","HOMEM"
"251430505000003","8","140","19","159","88.050314465408800","11.9496855345911950","HOMEM"
"251430505000004","8","83","10","93","89.247311827956990","10.7526881720430100","HOMEM"
"251430505000005","8","222","42","264","84.090909090909100","15.9090909090909080","HOMEM"
"251430505000006","8","119","32","151","78.807947019867560","21.1920529801324520","HOMEM"
"251430505000007","8","55","8","63","87.301587301587300","12.6984126984126980","HOMEM"
"251430505000008","1","178","41","219","81.278538812785380","18.7214611872146100","HOMEM"
"251440405000001","1","114","162","276","41.304347826086950","58.6956521739130500","MULHER"
"251440405000002","1","86","120","206","41.747572815533980","58.2524271844660200","MULHER"
"251440405000003","8","145","35","180","80.555555555555560","19.4444444444444430","HOMEM"
"251440405000004","8","88","11","99","88.888888888888890","11.1111111111111100","HOMEM"
"251440405000005","8","46","1","47","97.872340425531920","2.1276595744680850","HOMEM"
"251440405000006","8","48","19","67","71.641791044776110","28.3582089552238800","HOMEM"
"251440405000007","8","39","12","51","76.470588235294120","23.5294117647058840","HOMEM"
"251440405000008","8","69","12","81","85.185185185185190","14.8148148148148150","HOMEM"
"251440405000009","8","63","8","71","88.732394366197180","11.2676056338028160","HOMEM"
"251440405000010","8","106","15","121","87.603305785123960","12.3966942148760340","HOMEM"
"251440405000011","8","25","5","30","83.333333333333330","16.6666666666666680","HOMEM"
"251440405000012","8","63","6","69","91.304347826086950","8.6956521739130430","HOMEM"
"251445305000001","1","170","154","324","52.469135802469130","47.5308641975308700","HOMEM"
"251445305000002","1","98","256","354","27.683615819209038","72.3163841807909600","MULHER"
"251445305000003","8","37","123","160","23.125000000000000","76.8750000000000000","MULHER"
"251445305000004","8","69","153","222","31.081081081081080","68.9189189189189200","MULHER"
"251445305000005","8","114","169","283","40.282685512367490","59.7173144876325100","MULHER"
"251445305000006","8","64","123","187","34.224598930481285","65.7754010695187200","MULHER"
"251450305000001","1","133","98","231","57.575757575757580","42.4242424242424200","HOMEM"
"251450305000002","1","222","107","329","67.477203647416420","32.5227963525835800","HOMEM"
"251450305000003","1","136","85","221","61.538461538461540","38.4615384615384600","HOMEM"
"251450305000004","1","139","85","224","62.053571428571430","37.9464285714285700","HOMEM"
"251450305000005","1","234","72","306","76.470588235294120","23.5294117647058840","HOMEM"
"251450305000006","1","114","53","167","68.263473053892210","31.7365269461077840","HOMEM"
"251450305000007","8","93","19","112","83.035714285714290","16.9642857142857150","HOMEM"
"251450305000008","8","26","3","29","89.655172413793110","10.3448275862068970","HOMEM"
"251450305000009","8","61","7","68","89.705882352941170","10.2941176470588240","HOMEM"
"251450305000010","8","73","19","92","79.347826086956520","20.6521739130434770","HOMEM"
"251450305000011","8","119","15","134","88.805970149253720","11.1940298507462690","HOMEM"
"251450305000012","8","106","22","128","82.812500000000000","17.1875000000000000","HOMEM"
"251450305000013","8","74","12","86","86.046511627906980","13.9534883720930230","HOMEM"
"251450305000014","8","128","20","148","86.486486486486480","13.5135135135135140","HOMEM"
"251450305000015","8","146","39","185","78.918918918918920","21.0810810810810800","HOMEM"
"251450305000016","8","74","18","92","80.434782608695660","19.5652173913043480","HOMEM"
"251450305000017","8","79","82","161","49.068322981366460","50.9316770186335400","MULHER"
"251450305000018","8","178","31","209","85.167464114832540","14.8325358851674650","HOMEM"
"251450305000019","8","117","20","137","85.401459854014600","14.5985401459854010","HOMEM"
"251450305000020","8","96","13","109","88.073394495412840","11.9266055045871560","HOMEM"
"251450305000021","8","44","6","50","88.000000000000000","12.0000000000000000","HOMEM"
"251450305000022","8","96","16","112","85.714285714285710","14.2857142857142860","HOMEM"
"251450305000023","1","211","86","297","71.043771043771050","28.9562289562289550","HOMEM"
"251450305000024","1","182","66","248","73.387096774193550","26.6129032258064520","HOMEM"
"251450305000025","1","180","68","248","72.580645161290320","27.4193548387096760","HOMEM"
"251450305000026","1","230","64","294","78.231292517006800","21.7687074829931970","HOMEM"
"251450305000027","1","80","247","327","24.464831804281346","75.5351681957186500","MULHER"
"251450305000028","1","157","55","212","74.056603773584910","25.9433962264150930","HOMEM"
"251450305000029","5","96","11","107","89.719626168224300","10.2803738317757020","HOMEM"
"251450310000001","1","55","14","69","79.710144927536230","20.2898550724637700","HOMEM"
"251450310000002","8","108","9","117","92.307692307692300","7.6923076923076925","HOMEM"
"251450310000003","8","97","23","120","80.833333333333330","19.1666666666666680","HOMEM"
"251455205000001","1","119","75","194","61.340206185567010","38.6597938144329900","HOMEM"
"251455205000002","8","76","23","99","76.767676767676760","23.2323232323232320","HOMEM"
"251455205000003","8","107","31","138","77.536231884057970","22.4637681159420270","HOMEM"
"251455205000004","8","44","36","80","55.000000000000000","45.0000000000000000","HOMEM"
"251455205000005","8","66","30","96","68.750000000000000","31.2500000000000000","HOMEM"
"251455205000006","8","125","25","150","83.333333333333330","16.6666666666666680","HOMEM"
"251455205000007","8","45","22","67","67.164179104477610","32.8358208955223900","HOMEM"
"251455205000008","8","81","30","111","72.972972972972970","27.0270270270270280","HOMEM"
"251455205000009","8","108","55","163","66.257668711656440","33.7423312883435600","HOMEM"
"251460205000001","1","17","59","76","22.368421052631580","77.6315789473684200","MULHER"
"251460205000002","8","33","134","167","19.760479041916167","80.2395209580838300","MULHER"
"251460205000003","8","55","119","174","31.609195402298850","68.3908045977011500","MULHER"
"251460205000004","8","18","38","56","32.142857142857146","67.8571428571428600","MULHER"
"251460205000005","8","27","67","94","28.723404255319150","71.2765957446808500","MULHER"
"251460205000006","1","188","126","314","59.872611464968150","40.1273885350318500","HOMEM"
"251465105000001","1","104","141","245","42.448979591836730","57.5510204081632700","MULHER"
"251465105000002","8","45","52","97","46.391752577319586","53.6082474226804140","MULHER"
"251465105000003","8","28","31","59","47.457627118644070","52.5423728813559300","MULHER"
"251465105000004","8","21","0","21","100.000000000000000","0.0000000000000000","HOMEM"
"251470105000001","1","163","143","306","53.267973856209150","46.7320261437908500","HOMEM"
"251470105000002","1","153","49","202","75.742574257425740","24.2574257425742560","HOMEM"
"251470105000003","8","44","1","45","97.777777777777770","2.2222222222222223","HOMEM"
"251470105000004","8","73","23","96","76.041666666666670","23.9583333333333320","HOMEM"
"251470105000005","8","24","2","26","92.307692307692300","7.6923076923076925","HOMEM"
"251470105000006","8","123","36","159","77.358490566037730","22.6415094339622630","HOMEM"
"251470105000007","8","52","8","60","86.666666666666670","13.3333333333333340","HOMEM"
"251470105000008","1","161","79","240","67.083333333333330","32.9166666666666640","HOMEM"
"251480005000001","1","183","130","313","58.466453674121404","41.5335463258785960","HOMEM"
"251480005000002","1","154","71","225","68.444444444444440","31.5555555555555570","HOMEM"
"251480005000003","8","169","41","210","80.476190476190480","19.5238095238095260","HOMEM"
"251480005000004","8","47","22","69","68.115942028985500","31.8840579710144920","HOMEM"
"251480005000005","8","147","46","193","76.165803108808290","23.8341968911917100","HOMEM"
"251480005000006","8","94","90","184","51.086956521739130","48.9130434782608700","HOMEM"
"251480005000007","8","46","17","63","73.015873015873010","26.9841269841269840","HOMEM"
"251490905000001","1","46","168","214","21.495327102803740","78.5046728971962600","MULHER"
"251490905000002","1","71","139","210","33.809523809523810","66.1904761904761900","MULHER"
"251490905000003","1","170","93","263","64.638783269961980","35.3612167300380240","HOMEM"
"251490905000004","1","90","90","180","50.000000000000000","50.0000000000000000","IGUAL"
"251490905000005","1","179","129","308","58.116883116883116","41.8831168831168840","HOMEM"
"251490905000006","1","184","95","279","65.949820788530460","34.0501792114695300","HOMEM"
"251490905000007","8","70","10","80","87.500000000000000","12.5000000000000000","HOMEM"
"251490905000008","8","37","3","40","92.500000000000000","7.5000000000000000","HOMEM"
"251490905000009","8","41","4","45","91.111111111111110","8.8888888888888900","HOMEM"
"251490905000010","8","48","8","56","85.714285714285710","14.2857142857142860","HOMEM"
"251490905000011","8","36","34","70","51.428571428571430","48.5714285714285700","HOMEM"
"251490905000012","8","47","11","58","81.034482758620680","18.9655172413793100","HOMEM"
"251490905000013","8","65","8","73","89.041095890410960","10.9589041095890400","HOMEM"
"251490905000014","8","23","8","31","74.193548387096770","25.8064516129032240","HOMEM"
"251490905000015","8","50","7","57","87.719298245614040","12.2807017543859660","HOMEM"
"251490905000016","1","133","57","190","70.000000000000000","30.0000000000000000","HOMEM"
"251490905000017","1","130","62","192","67.708333333333330","32.2916666666666640","HOMEM"
"251500505000001","1","95","106","201","47.263681592039800","52.7363184079602000","MULHER"
"251500505000002","1","128","96","224","57.142857142857146","42.8571428571428540","HOMEM"
"251500505000003","8","128","117","245","52.244897959183675","47.7551020408163250","HOMEM"
"251500505000004","8","123","24","147","83.673469387755100","16.3265306122449000","HOMEM"
"251500505000005","8","150","47","197","76.142131979695440","23.8578680203045700","HOMEM"
"251500505000006","8","177","180","357","49.579831932773110","50.4201680672268900","MULHER"
"251500505000007","8","11","8","19","57.894736842105260","42.1052631578947400","HOMEM"
"251500505000008","1","72","74","146","49.315068493150680","50.6849315068493200","MULHER"
"251500505000009","1","142","95","237","59.915611814345990","40.0843881856540100","HOMEM"
"251510405000001","1","124","79","203","61.083743842364534","38.9162561576354660","HOMEM"
"251510405000002","1","181","99","280","64.642857142857140","35.3571428571428540","HOMEM"
"251510405000003","1","228","104","332","68.674698795180720","31.3253012048192760","HOMEM"
"251510405000004","8","91","26","117","77.777777777777770","22.2222222222222200","HOMEM"
"251510405000005","8","176","67","243","72.427983539094650","27.5720164609053500","HOMEM"
"251510405000006","8","229","56","285","80.350877192982450","19.6491228070175450","HOMEM"
"251510405000007","8","117","46","163","71.779141104294480","28.2208588957055220","HOMEM"
"251510405000008","8","39","14","53","73.584905660377360","26.4150943396226400","HOMEM"
"251510405000009","8","146","44","190","76.842105263157890","23.1578947368421060","HOMEM"
"251510405000010","8","71","22","93","76.344086021505380","23.6559139784946240","HOMEM"
"251510405000011","8","82","61","143","57.342657342657340","42.6573426573426600","HOMEM"
"251510405000012","8","301","141","442","68.099547511312220","31.9004524886877830","HOMEM"
"251510405000013","1","136","75","211","64.454976303317540","35.5450236966824600","HOMEM"
"251510405000014","1","83","43","126","65.873015873015870","34.1269841269841300","HOMEM"
"251510405000015","1","126","118","244","51.639344262295080","48.3606557377049200","HOMEM"
"251520305000001","1","52","79","131","39.694656488549620","60.3053435114503800","MULHER"
"251520305000002","1","72","79","151","47.682119205298015","52.3178807947019850","MULHER"
"251520305000003","8","58","67","125","46.400000000000000","53.6000000000000000","MULHER"
"251520305000004","8","111","11","122","90.983606557377040","9.0163934426229500","HOMEM"
"251520305000005","8","69","27","96","71.875000000000000","28.1250000000000000","HOMEM"
"251520305000006","1","166","85","251","66.135458167330680","33.8645418326693250","HOMEM"
"251520305000007","1","90","78","168","53.571428571428570","46.4285714285714300","HOMEM"
"251530205000001","1","152","113","265","57.358490566037740","42.6415094339622600","HOMEM"
"251530205000002","1","212","100","312","67.948717948717940","32.0512820512820500","HOMEM"
"251530205000003","1","149","53","202","73.762376237623770","26.2376237623762380","HOMEM"
"251530205000004","1","150","106","256","58.593750000000000","41.4062500000000000","HOMEM"
"251530205000005","1","100","65","165","60.606060606060610","39.3939393939393900","HOMEM"
"251530205000006","1","64","186","250","25.600000000000000","74.4000000000000000","MULHER"
"251530205000007","1","132","93","225","58.666666666666664","41.3333333333333360","HOMEM"
"251530205000008","1","128","105","233","54.935622317596570","45.0643776824034300","HOMEM"
"251530205000009","1","86","211","297","28.956228956228955","71.0437710437710500","MULHER"
"251530205000010","1","135","99","234","57.692307692307690","42.3076923076923100","HOMEM"
"251530205000011","1","95","285","380","25.000000000000000","75.0000000000000000","MULHER"
"251530205000012","1","138","94","232","59.482758620689660","40.5172413793103400","HOMEM"
"251530205000013","1","213","113","326","65.337423312883430","34.6625766871165600","HOMEM"
"251530205000014","1","127","105","232","54.741379310344826","45.2586206896551740","HOMEM"
"251530205000015","1","58","156","214","27.102803738317757","72.8971962616822400","MULHER"
"251530205000016","1","75","175","250","30.000000000000000","70.0000000000000000","MULHER"
"251530205000017","1","91","138","229","39.737991266375545","60.2620087336244550","MULHER"
"251530205000018","1","154","123","277","55.595667870036100","44.4043321299639000","HOMEM"
"251530205000019","1","196","83","279","70.250896057347670","29.7491039426523300","HOMEM"
"251530205000020","1","276","113","389","70.951156812339330","29.0488431876606700","HOMEM"
"251530205000021","1","115","131","246","46.747967479674800","53.2520325203252000","MULHER"
"251530205000022","1","64","36","100","64.000000000000000","36.0000000000000000","HOMEM"
"251530205000023","1","161","134","295","54.576271186440680","45.4237288135593200","HOMEM"
"251530205000024","1","186","112","298","62.416107382550340","37.5838926174496600","HOMEM"
"251530205000025","1","197","103","300","65.666666666666670","34.3333333333333360","HOMEM"
"251530205000026","1","187","100","287","65.156794425087110","34.8432055749128900","HOMEM"
"251530205000027","1","156","64","220","70.909090909090900","29.0909090909090900","HOMEM"
"251530205000028","1","248","100","348","71.264367816091950","28.7356321839080450","HOMEM"
"251530205000029","1","192","88","280","68.571428571428570","31.4285714285714270","HOMEM"
"251530205000030","1","130","87","217","59.907834101382490","40.0921658986175100","HOMEM"
"251530205000031","1","299","216","515","58.058252427184460","41.9417475728155400","HOMEM"
"251530205000032","1","145","113","258","56.201550387596896","43.7984496124031040","HOMEM"
"251530205000033","1","237","104","341","69.501466275659820","30.4985337243401770","HOMEM"
"251530205000034","1","164","59","223","73.542600896860990","26.4573991031390140","HOMEM"
"251530205000035","1","118","370","488","24.180327868852460","75.8196721311475400","MULHER"
"251530205000036","1","84","60","144","58.333333333333336","41.6666666666666640","HOMEM"
"251530205000037","8","108","25","133","81.203007518797000","18.7969924812030060","HOMEM"
"251530205000038","8","76","15","91","83.516483516483520","16.4835164835164820","HOMEM"
"251530205000039","8","48","17","65","73.846153846153840","26.1538461538461530","HOMEM"
"251530205000040","8","68","13","81","83.950617283950620","16.0493827160493830","HOMEM"
"251530205000041","5","54","7","61","88.524590163934420","11.4754098360655730","HOMEM"
"251530205000042","8","54","77","131","41.221374045801525","58.7786259541984750","MULHER"
"251530205000043","8","192","40","232","82.758620689655170","17.2413793103448300","HOMEM"
"251530205000044","8","195","33","228","85.526315789473680","14.4736842105263150","HOMEM"
"251530205000045","8","171","46","217","78.801843317972360","21.1981566820276500","HOMEM"
"251530205000046","8","96","19","115","83.478260869565220","16.5217391304347800","HOMEM"
"251530205000047","8","178","34","212","83.962264150943400","16.0377358490566020","HOMEM"
"251530205000048","5","349","93","442","78.959276018099540","21.0407239819004520","HOMEM"
"251530205000049","5","113","63","176","64.204545454545450","35.7954545454545500","HOMEM"
"251530205000050","5","66","38","104","63.461538461538460","36.5384615384615400","HOMEM"
"251530205000051","5","40","9","49","81.632653061224490","18.3673469387755120","HOMEM"
"251530205000052","5","55","8","63","87.301587301587300","12.6984126984126980","HOMEM"
"251530205000053","5","95","48","143","66.433566433566440","33.5664335664335700","HOMEM"
"251530205000054","5","112","62","174","64.367816091954030","35.6321839080459740","HOMEM"
"251530205000055","1","109","57","166","65.662650602409640","34.3373493975903600","HOMEM"
"251530205000056","1","62","157","219","28.310502283105023","71.6894977168949800","MULHER"
"251530205000057","1","91","89","180","50.555555555555560","49.4444444444444400","HOMEM"
"251530205000058","1","175","64","239","73.221757322175730","26.7782426778242670","HOMEM"
"251530205000059","5","16","31","47","34.042553191489360","65.9574468085106400","MULHER"
"251530220000001","1","242","72","314","77.070063694267520","22.9299363057324830","HOMEM"
"251530220000002","8","56","6","62","90.322580645161300","9.6774193548387100","HOMEM"
"251530220000003","8","74","12","86","86.046511627906980","13.9534883720930230","HOMEM"
"251530220000004","8","136","52","188","72.340425531914890","27.6595744680851080","HOMEM"
"251540105000001","1","84","100","184","45.652173913043480","54.3478260869565200","MULHER"
"251540105000002","8","94","7","101","93.069306930693070","6.9306930693069310","HOMEM"
"251540110000001","1","212","106","318","66.666666666666670","33.3333333333333360","HOMEM"
"251540110000002","1","131","70","201","65.174129353233840","34.8258706467661700","HOMEM"
"251540110000003","1","208","123","331","62.839879154078550","37.1601208459214500","HOMEM"
"251540110000004","8","93","53","146","63.698630136986300","36.3013698630137000","HOMEM"
"251540110000005","8","263","52","315","83.492063492063500","16.5079365079365100","HOMEM"
"251540110000006","8","248","81","329","75.379939209726440","24.6200607902735560","HOMEM"
"251540110000007","8","341","144","485","70.309278350515470","29.6907216494845370","HOMEM"
"251540110000008","1","138","74","212","65.094339622641510","34.9056603773584940","HOMEM"
"251550005000001","1","61","61","122","50.000000000000000","50.0000000000000000","IGUAL"
"251550005000002","1","111","91","202","54.950495049504950","45.0495049504950500","HOMEM"
"251550005000003","1","116","126","242","47.933884297520660","52.0661157024793400","MULHER"
"251550005000004","1","128","140","268","47.761194029850750","52.2388059701492500","MULHER"
"251550005000005","1","127","136","263","48.288973384030420","51.7110266159695800","MULHER"
"251550005000006","1","161","152","313","51.437699680511180","48.5623003194888200","HOMEM"
"251550005000007","1","163","137","300","54.333333333333336","45.6666666666666640","HOMEM"
"251550005000008","1","84","239","323","26.006191950464395","73.9938080495356000","MULHER"
"251550005000009","1","125","160","285","43.859649122807020","56.1403508771929800","MULHER"
"251550005000010","8","75","22","97","77.319587628865970","22.6804123711340200","HOMEM"
"251550005000011","8","59","89","148","39.864864864864860","60.1351351351351400","MULHER"
"251550005000012","8","58","26","84","69.047619047619050","30.9523809523809530","HOMEM"
"251550005000013","8","112","55","167","67.065868263473050","32.9341317365269400","HOMEM"
"251550005000014","8","128","48","176","72.727272727272730","27.2727272727272730","HOMEM"
"251550005000015","8","144","36","180","80.000000000000000","20.0000000000000000","HOMEM"
"251550005000016","4","119","66","185","64.324324324324320","35.6756756756756800","HOMEM"
"251550005000017","1","100","64","164","60.975609756097560","39.0243902439024400","HOMEM"
"251550015000001","1","112","73","185","60.540540540540540","39.4594594594594600","HOMEM"
"251550015000002","8","43","27","70","61.428571428571430","38.5714285714285700","HOMEM"
"251550015000003","8","35","15","50","70.000000000000000","30.0000000000000000","HOMEM"
"251550020000001","1","18","10","28","64.285714285714290","35.7142857142857150","HOMEM"
"251550020000002","8","37","40","77","48.051948051948050","51.9480519480519500","MULHER"
"251550020000003","8","50","75","125","40.000000000000000","60.0000000000000000","MULHER"
"251550020000004","5","19","25","44","43.181818181818180","56.8181818181818200","MULHER"
"251560905000001","1","159","139","298","53.355704697986575","46.6442953020134250","HOMEM"
"251560905000002","1","143","171","314","45.541401273885350","54.4585987261146500","MULHER"
"251560905000003","8","59","35","94","62.765957446808514","37.2340425531914860","HOMEM"
"251560905000004","4","55","46","101","54.455445544554460","45.5445544554455400","HOMEM"
"251560905000005","8","63","26","89","70.786516853932580","29.2134831460674140","HOMEM"
"251570805000001","1","204","107","311","65.594855305466240","34.4051446945337600","HOMEM"
"251570805000002","1","162","80","242","66.942148760330580","33.0578512396694200","HOMEM"
"251570805000003","8","98","23","121","80.991735537190080","19.0082644628099200","HOMEM"
"251570805000004","8","147","40","187","78.609625668449200","21.3903743315508020","HOMEM"
"251580705000001","1","117","180","297","39.393939393939390","60.6060606060606100","MULHER"
"251580705000002","1","109","172","281","38.790035587188610","61.2099644128113900","MULHER"
"251580705000003","1","173","116","289","59.861591695501730","40.1384083044982700","HOMEM"
"251580705000004","1","178","147","325","54.769230769230770","45.2307692307692300","HOMEM"
"251580705000005","8","30","10","40","75.000000000000000","25.0000000000000000","HOMEM"
"251580705000006","8","75","33","108","69.444444444444440","30.5555555555555570","HOMEM"
"251580705000007","8","93","29","122","76.229508196721310","23.7704918032786880","HOMEM"
"251580705000008","8","32","37","69","46.376811594202900","53.6231884057971000","MULHER"
"251580705000009","8","83","145","228","36.403508771929820","63.5964912280701800","MULHER"
"251580705000010","8","68","47","115","59.130434782608695","40.8695652173913050","HOMEM"
"251580705000011","8","111","88","199","55.778894472361806","44.2211055276381940","HOMEM"
"251580705000012","4","20","100","120","16.666666666666668","83.3333333333333300","MULHER"
"251590605000001","1","144","162","306","47.058823529411770","52.9411764705882300","MULHER"
"251590605000002","1","95","63","158","60.126582278481010","39.8734177215189900","HOMEM"
"251590605000003","1","137","76","213","64.319248826291070","35.6807511737089200","HOMEM"
"251590605000004","8","69","7","76","90.789473684210520","9.2105263157894740","HOMEM"
"251590605000005","8","9","2","11","81.818181818181810","18.1818181818181830","HOMEM"
"251590605000006","8","27","2","29","93.103448275862060","6.8965517241379310","HOMEM"
"251590605000007","8","16","1","17","94.117647058823540","5.8823529411764710","HOMEM"
"251590605000008","8","37","5","42","88.095238095238100","11.9047619047619050","HOMEM"
"251590605000009","8","86","18","104","82.692307692307700","17.3076923076923070","HOMEM"
"251590605000010","8","49","31","80","61.250000000000000","38.7500000000000000","HOMEM"
"251590605000011","8","88","24","112","78.571428571428570","21.4285714285714270","HOMEM"
"251590605000012","8","9","5","14","64.285714285714290","35.7142857142857150","HOMEM"
"251590605000013","1","121","74","195","62.051282051282050","37.9487179487179500","HOMEM"
"251590605000014","1","94","40","134","70.149253731343280","29.8507462686567170","HOMEM"
"251590605000015","8","174","39","213","81.690140845070420","18.3098591549295760","HOMEM"
"251593005000001","1","154","83","237","64.978902953586500","35.0210970464135000","HOMEM"
"251593005000002","1","103","56","159","64.779874213836480","35.2201257861635200","HOMEM"
"251593005000003","8","106","20","126","84.126984126984130","15.8730158730158730","HOMEM"
"251593005000004","8","137","39","176","77.840909090909100","22.1590909090909100","HOMEM"
"251593005000005","1","243","85","328","74.085365853658530","25.9146341463414630","HOMEM"
"251593005000006","1","173","86","259","66.795366795366790","33.2046332046332040","HOMEM"
"251597105000001","1","152","103","255","59.607843137254900","40.3921568627451000","HOMEM"
"251597105000002","8","113","53","166","68.072289156626510","31.9277108433734930","HOMEM"
"251597105000003","8","192","63","255","75.294117647058830","24.7058823529411780","HOMEM"
"251597105000004","8","90","45","135","66.666666666666670","33.3333333333333360","HOMEM"
"251597105000005","8","65","25","90","72.222222222222230","27.7777777777777800","HOMEM"
"251597105000006","8","123","32","155","79.354838709677420","20.6451612903225800","HOMEM"
"251597105000007","8","164","41","205","80.000000000000000","20.0000000000000000","HOMEM"
"251597105000008","8","117","55","172","68.023255813953480","31.9767441860465130","HOMEM"
"251597105000009","8","69","30","99","69.696969696969700","30.3030303030303050","HOMEM"
"251597105000010","5","103","49","152","67.763157894736840","32.2368421052631600","HOMEM"
"251597105000011","8","143","96","239","59.832635983263600","40.1673640167364000","HOMEM"
"251597105000012","8","80","28","108","74.074074074074080","25.9259259259259270","HOMEM"
"251600305000001","1","86","162","248","34.677419354838710","65.3225806451613000","MULHER"
"251600305000002","1","88","219","307","28.664495114006513","71.3355048859934900","MULHER"
"251600305000003","1","133","134","267","49.812734082397010","50.1872659176029900","MULHER"
"251600305000004","1","64","80","144","44.444444444444440","55.5555555555555600","MULHER"
"251600305000005","1","71","182","253","28.063241106719367","71.9367588932806300","MULHER"
"251600305000006","1","223","104","327","68.195718654434240","31.8042813455657480","HOMEM"
"251600305000007","1","89","225","314","28.343949044585987","71.6560509554140200","MULHER"
"251600305000008","1","235","200","435","54.022988505747130","45.9770114942528700","HOMEM"
"251600305000009","1","71","142","213","33.333333333333336","66.6666666666666700","MULHER"
"251600305000010","1","184","121","305","60.327868852459020","39.6721311475409800","HOMEM"
"251600305000011","1","136","145","281","48.398576512455510","51.6014234875444900","MULHER"
"251600305000012","1","211","107","318","66.352201257861640","33.6477987421383600","HOMEM"
"251600305000013","1","135","122","257","52.529182879377430","47.4708171206225700","HOMEM"
"251600305000014","1","124","94","218","56.880733944954130","43.1192660550458700","HOMEM"
"251600305000015","1","174","113","287","60.627177700348430","39.3728222996515700","HOMEM"
"251600305000016","1","109","90","199","54.773869346733670","45.2261306532663300","HOMEM"
"251600305000017","1","127","108","235","54.042553191489360","45.9574468085106400","HOMEM"
"251600305000018","1","136","119","255","53.333333333333336","46.6666666666666640","HOMEM"
"251600305000019","1","109","164","273","39.926739926739930","60.0732600732600700","MULHER"
"251600305000020","1","127","84","211","60.189573459715640","39.8104265402843600","HOMEM"
"251600305000021","8","68","156","224","30.357142857142858","69.6428571428571400","MULHER"
"251600305000022","8","31","56","87","35.632183908045974","64.3678160919540300","MULHER"
"251600305000023","8","71","43","114","62.280701754385966","37.7192982456140340","HOMEM"
"251600305000024","8","167","48","215","77.674418604651170","22.3255813953488380","HOMEM"
"251600305000025","8","39","22","61","63.934426229508200","36.0655737704918000","HOMEM"
"251600305000026","8","92","35","127","72.440944881889760","27.5590551181102370","HOMEM"
"251600305000027","8","41","13","54","75.925925925925920","24.0740740740740730","HOMEM"
"251600305000028","8","109","17","126","86.507936507936500","13.4920634920634920","HOMEM"
"251600305000029","8","30","43","73","41.095890410958900","58.9041095890411000","MULHER"
"251600305000030","8","87","25","112","77.678571428571430","22.3214285714285730","HOMEM"
"251600305000031","8","68","7","75","90.666666666666670","9.3333333333333340","HOMEM"
"251600305000032","5","84","113","197","42.639593908629440","57.3604060913705600","MULHER"
"251600305000033","8","28","40","68","41.176470588235300","58.8235294117647000","MULHER"
"251600305000034","8","113","36","149","75.838926174496650","24.1610738255033550","HOMEM"
"251600305000035","1","89","62","151","58.940397350993380","41.0596026490066200","HOMEM"
"251600305000036","1","74","53","127","58.267716535433074","41.7322834645669260","HOMEM"
"251600305000037","8","81","65","146","55.479452054794520","44.5205479452054800","HOMEM"
"251600305000038","8","47","16","63","74.603174603174610","25.3968253968253950","HOMEM"
"251600305000039","8","120","36","156","76.923076923076920","23.0769230769230770","HOMEM"
"251610205000001","1","112","118","230","48.695652173913050","51.3043478260869500","MULHER"
"251610205000002","1","139","91","230","60.434782608695650","39.5652173913043500","HOMEM"
"251610205000003","1","125","78","203","61.576354679802954","38.4236453201970460","HOMEM"
"251610205000004","1","156","72","228","68.421052631578950","31.5789473684210500","HOMEM"
"251610205000005","1","89","98","187","47.593582887700535","52.4064171122994650","MULHER"
"251610205000006","1","101","108","209","48.325358851674640","51.6746411483253600","MULHER"
"251610205000007","1","124","54","178","69.662921348314610","30.3370786516853920","HOMEM"
"251610205000008","1","123","99","222","55.405405405405400","44.5945945945946000","HOMEM"
"251610205000009","8","121","35","156","77.564102564102570","22.4358974358974340","HOMEM"
"251610205000010","8","165","63","228","72.368421052631580","27.6315789473684200","HOMEM"
"251610205000011","8","135","32","167","80.838323353293420","19.1616766467065850","HOMEM"
"251610205000012","8","149","44","193","77.202072538860110","22.7979274611398960","HOMEM"
"251610205000013","1","140","110","250","56.000000000000000","44.0000000000000000","HOMEM"
"251610205000014","1","160","76","236","67.796610169491530","32.2033898305084800","HOMEM"
"251610205000015","1","152","53","205","74.146341463414630","25.8536585365853680","HOMEM"
"251610205000016","1","133","82","215","61.860465116279070","38.1395348837209300","HOMEM"
"251610205000017","1","117","56","173","67.630057803468200","32.3699421965317950","HOMEM"
"251610205000018","1","101","72","173","58.381502890173410","41.6184971098265900","HOMEM"
"251610210000001","1","12","8","20","60.000000000000000","40.0000000000000000","HOMEM"
"251610210000002","8","173","63","236","73.305084745762710","26.6949152542372870","HOMEM"
"251615105000001","1","115","86","201","57.213930348258710","42.7860696517412900","HOMEM"
"251615105000002","1","156","135","291","53.608247422680414","46.3917525773195860","HOMEM"
"251615105000003","8","73","13","86","84.883720930232560","15.1162790697674420","HOMEM"
"251615105000004","8","59","9","68","86.764705882352940","13.2352941176470580","HOMEM"
"251615105000005","8","71","17","88","80.681818181818190","19.3181818181818170","HOMEM"
"251615105000006","8","66","21","87","75.862068965517240","24.1379310344827580","HOMEM"
"251615105000007","5","32","8","40","80.000000000000000","20.0000000000000000","HOMEM"
"251615105000008","5","36","22","58","62.068965517241380","37.9310344827586200","HOMEM"
"251620105000001","1","113","65","178","63.483146067415730","36.5168539325842700","HOMEM"
"251620105000002","1","210","98","308","68.181818181818190","31.8181818181818170","HOMEM"
"251620105000003","1","136","157","293","46.416382252559730","53.5836177474402700","MULHER"
"251620105000004","1","211","121","332","63.554216867469880","36.4457831325301200","HOMEM"
"251620105000005","1","100","152","252","39.682539682539684","60.3174603174603160","MULHER"
"251620105000006","1","121","72","193","62.694300518134720","37.3056994818652800","HOMEM"
"251620105000007","1","94","50","144","65.277777777777770","34.7222222222222200","HOMEM"
"251620105000008","1","224","92","316","70.886075949367080","29.1139240506329100","HOMEM"
"251620105000009","1","147","87","234","62.820512820512820","37.1794871794871800","HOMEM"
"251620105000010","1","136","98","234","58.119658119658120","41.8803418803418800","HOMEM"
"251620105000011","1","191","169","360","53.055555555555560","46.9444444444444400","HOMEM"
"251620105000012","1","116","144","260","44.615384615384610","55.3846153846153900","MULHER"
"251620105000013","1","200","143","343","58.309037900874635","41.6909620991253650","HOMEM"
"251620105000014","1","158","71","229","68.995633187772920","31.0043668122270760","HOMEM"
"251620105000015","1","214","71","285","75.087719298245620","24.9122807017543870","HOMEM"
"251620105000016","1","239","114","353","67.705382436260620","32.2946175637393800","HOMEM"
"251620105000017","1","180","61","241","74.688796680497930","25.3112033195020740","HOMEM"
"251620105000018","1","203","87","290","70.000000000000000","30.0000000000000000","HOMEM"
"251620105000019","1","179","151","330","54.242424242424240","45.7575757575757600","HOMEM"
"251620105000020","1","140","135","275","50.909090909090910","49.0909090909090900","HOMEM"
"251620105000021","1","170","103","273","62.271062271062270","37.7289377289377300","HOMEM"
"251620105000022","1","159","73","232","68.534482758620680","31.4655172413793100","HOMEM"
"251620105000023","1","85","110","195","43.589743589743590","56.4102564102564100","MULHER"
"251620105000024","1","64","143","207","30.917874396135264","69.0821256038647400","MULHER"
"251620105000025","1","132","121","253","52.173913043478260","47.8260869565217400","HOMEM"
"251620105000026","1","308","97","405","76.049382716049380","23.9506172839506170","HOMEM"
"251620105000027","1","295","115","410","71.951219512195120","28.0487804878048760","HOMEM"
"251620105000028","1","163","97","260","62.692307692307690","37.3076923076923100","HOMEM"
"251620105000029","1","148","95","243","60.905349794238680","39.0946502057613200","HOMEM"
"251620105000030","1","145","104","249","58.232931726907630","41.7670682730923700","HOMEM"
"251620105000031","1","186","76","262","70.992366412213740","29.0076335877862600","HOMEM"
"251620105000032","1","184","115","299","61.538461538461540","38.4615384615384600","HOMEM"
"251620105000033","1","192","135","327","58.715596330275230","41.2844036697247700","HOMEM"
"251620105000034","1","143","94","237","60.337552742616030","39.6624472573839700","HOMEM"
"251620105000035","1","299","105","404","74.009900990099010","25.9900990099009900","HOMEM"
"251620105000036","1","202","104","306","66.013071895424840","33.9869281045751600","HOMEM"
"251620105000037","1","118","69","187","63.101604278074866","36.8983957219251340","HOMEM"
"251620105000038","1","141","64","205","68.780487804878050","31.2195121951219500","HOMEM"
"251620105000039","1","229","110","339","67.551622418879060","32.4483775811209440","HOMEM"
"251620105000040","8","109","19","128","85.156250000000000","14.8437500000000000","HOMEM"
"251620105000041","8","150","19","169","88.757396449704150","11.2426035502958580","HOMEM"
"251620105000042","8","40","4","44","90.909090909090900","9.0909090909090920","HOMEM"
"251620105000043","8","182","29","211","86.255924170616110","13.7440758293838870","HOMEM"
"251620105000044","8","64","72","136","47.058823529411770","52.9411764705882300","MULHER"
"251620105000045","8","175","51","226","77.433628318584070","22.5663716814159300","HOMEM"
"251620105000046","8","178","30","208","85.576923076923080","14.4230769230769230","HOMEM"
"251620105000047","5","28","10","38","73.684210526315800","26.3157894736842100","HOMEM"
"251620105000048","8","83","20","103","80.582524271844660","19.4174757281553400","HOMEM"
"251620105000049","8","149","43","192","77.604166666666670","22.3958333333333320","HOMEM"
"251620105000050","8","48","5","53","90.566037735849050","9.4339622641509440","HOMEM"
"251620105000051","8","244","37","281","86.832740213523140","13.1672597864768690","HOMEM"
"251620105000052","6","199","60","259","76.833976833976830","23.1660231660231660","HOMEM"
"251620105000053","6","54","167","221","24.434389140271490","75.5656108597285100","MULHER"
"251620105000054","8","92","15","107","85.981308411214950","14.0186915887850460","HOMEM"
"251620105000055","6","125","59","184","67.934782608695660","32.0652173913043500","HOMEM"
"251620105000056","6","369","78","447","82.550335570469800","17.4496644295302020","HOMEM"
"251620105000057","8","139","35","174","79.885057471264370","20.1149425287356320","HOMEM"
"251620105000059","5","55","13","68","80.882352941176460","19.1176470588235300","HOMEM"
"251620105000060","1","160","134","294","54.421768707482990","45.5782312925170100","HOMEM"
"251620105000061","1","191","113","304","62.828947368421055","37.1710526315789450","HOMEM"
"251620105000062","1","162","44","206","78.640776699029130","21.3592233009708750","HOMEM"
"251620105000063","1","135","57","192","70.312500000000000","29.6875000000000000","HOMEM"
"251620105000064","1","135","64","199","67.839195979899500","32.1608040201005000","HOMEM"
"251620105000065","1","119","59","178","66.853932584269660","33.1460674157303360","HOMEM"
"251620105000066","1","115","63","178","64.606741573033700","35.3932584269662900","HOMEM"
"251620105000067","1","263","109","372","70.698924731182800","29.3010752688172040","HOMEM"
"251620105000068","1","26","23","49","53.061224489795920","46.9387755102040800","HOMEM"
"251620105000069","1","81","181","262","30.916030534351144","69.0839694656488500","MULHER"
"251620105000070","1","176","141","317","55.520504731861200","44.4794952681388000","HOMEM"
"251620105000071","1","111","100","211","52.606635071090050","47.3933649289099500","HOMEM"
"251620105000072","1","131","135","266","49.248120300751880","50.7518796992481200","MULHER"
"251620105000073","1","55","24","79","69.620253164556960","30.3797468354430360","HOMEM"
"251620105000074","1","170","157","327","51.987767584097860","48.0122324159021400","HOMEM"
"251620105000075","1","126","58","184","68.478260869565220","31.5217391304347800","HOMEM"
"251620105000076","1","274","112","386","70.984455958549220","29.0155440414507770","HOMEM"
"251620105000077","1","61","23","84","72.619047619047620","27.3809523809523800","HOMEM"
"251620105000078","6","242","42","284","85.211267605633810","14.7887323943661980","HOMEM"
"251620105000079","6","161","46","207","77.777777777777770","22.2222222222222200","HOMEM"
"251620105000080","8","78","29","107","72.897196261682240","27.1028037383177570","HOMEM"
"251620105000081","5","52","12","64","81.250000000000000","18.7500000000000000","HOMEM"
"251630005000001","1","56","176","232","24.137931034482758","75.8620689655172400","MULHER"
"251630005000002","1","180","144","324","55.555555555555560","44.4444444444444400","HOMEM"
"251630005000003","1","132","167","299","44.147157190635454","55.8528428093645460","MULHER"
"251630005000004","1","144","145","289","49.826989619377166","50.1730103806228340","MULHER"
"251630005000005","1","152","117","269","56.505576208178440","43.4944237918215600","HOMEM"
"251630005000006","1","68","200","268","25.373134328358210","74.6268656716418000","MULHER"
"251630005000007","1","119","107","226","52.654867256637170","47.3451327433628300","HOMEM"
"251630005000008","1","87","155","242","35.950413223140494","64.0495867768595000","MULHER"
"251630005000009","1","176","138","314","56.050955414012740","43.9490445859872600","HOMEM"
"251630005000010","1","99","99","198","50.000000000000000","50.0000000000000000","IGUAL"
"251630005000011","1","205","96","301","68.106312292358810","31.8936877076411950","HOMEM"
"251630005000012","1","118","55","173","68.208092485549130","31.7919075144508660","HOMEM"
"251630005000013","8","68","10","78","87.179487179487180","12.8205128205128210","HOMEM"
"251630005000014","8","119","38","157","75.796178343949040","24.2038216560509550","HOMEM"
"251630005000015","8","81","25","106","76.415094339622640","23.5849056603773600","HOMEM"
"251630005000016","8","88","17","105","83.809523809523810","16.1904761904761900","HOMEM"
"251630005000017","8","114","23","137","83.211678832116790","16.7883211678832100","HOMEM"
"251630005000018","8","121","43","164","73.780487804878050","26.2195121951219500","HOMEM"
"251630005000019","8","147","60","207","71.014492753623190","28.9855072463768120","HOMEM"
"251630005000020","1","82","61","143","57.342657342657340","42.6573426573426600","HOMEM"
"251630005000021","1","45","29","74","60.810810810810814","39.1891891891891860","HOMEM"
"251630005000022","1","135","97","232","58.189655172413794","41.8103448275862060","HOMEM"
"251630005000023","1","90","83","173","52.023121387283240","47.9768786127167600","HOMEM"
"251630005000024","1","137","136","273","50.183150183150180","49.8168498168498200","HOMEM"
"251630005000025","5","24","22","46","52.173913043478260","47.8260869565217400","HOMEM"
"251630015000001","1","34","45","79","43.037974683544306","56.9620253164556940","MULHER"
"251630015000002","8","135","72","207","65.217391304347830","34.7826086956521700","HOMEM"
"251640905000001","1","129","141","270","47.777777777777780","52.2222222222222200","MULHER"
"251640905000002","1","199","95","294","67.687074829931970","32.3129251700680300","HOMEM"
"251640905000003","1","78","74","152","51.315789473684210","48.6842105263157900","HOMEM"
"251640905000004","1","59","179","238","24.789915966386555","75.2100840336134400","MULHER"
"251640905000005","8","39","54","93","41.935483870967744","58.0645161290322560","MULHER"
"251640905000006","8","78","50","128","60.937500000000000","39.0625000000000000","HOMEM"
"251640905000007","5","109","70","179","60.893854748603350","39.1061452513966500","HOMEM"
"251640905000008","8","73","30","103","70.873786407766990","29.1262135922330100","HOMEM"
"251640905000009","8","55","12","67","82.089552238805960","17.9104477611940300","HOMEM"
"251640905000010","8","71","33","104","68.269230769230770","31.7307692307692300","HOMEM"
"251640905000011","5","128","39","167","76.646706586826340","23.3532934131736520","HOMEM"
"251640905000012","8","85","39","124","68.548387096774190","31.4516129032258080","HOMEM"
"251640905000013","5","51","38","89","57.303370786516850","42.6966292134831500","HOMEM"
"251640905000014","8","72","22","94","76.595744680851070","23.4042553191489380","HOMEM"
"251640905000015","8","75","25","100","75.000000000000000","25.0000000000000000","HOMEM"
"251640905000016","1","128","43","171","74.853801169590640","25.1461988304093570","HOMEM"
"251640905000017","5","41","25","66","62.121212121212125","37.8787878787878750","HOMEM"
"251640905000018","5","98","49","147","66.666666666666670","33.3333333333333360","HOMEM"
"251650805000001","1","68","163","231","29.437229437229437","70.5627705627705700","MULHER"
"251650805000002","1","45","47","92","48.913043478260870","51.0869565217391300","MULHER"
"251650805000003","1","153","111","264","57.954545454545450","42.0454545454545500","HOMEM"
"251650805000004","1","85","238","323","26.315789473684210","73.6842105263158000","MULHER"
"251650805000005","1","132","70","202","65.346534653465340","34.6534653465346500","HOMEM"
"251650805000006","1","135","91","226","59.734513274336280","40.2654867256637200","HOMEM"
"251650805000007","1","117","86","203","57.635467980295566","42.3645320197044340","HOMEM"
"251650805000008","1","107","94","201","53.233830845771145","46.7661691542288550","HOMEM"
"251650805000009","8","77","25","102","75.490196078431370","24.5098039215686300","HOMEM"
"251650805000010","8","149","24","173","86.127167630057800","13.8728323699421970","HOMEM"
"251650805000011","8","89","20","109","81.651376146788990","18.3486238532110100","HOMEM"
"251650805000012","8","99","18","117","84.615384615384610","15.3846153846153850","HOMEM"
"251650805000013","8","102","23","125","81.600000000000000","18.4000000000000000","HOMEM"
"251650805000014","8","144","32","176","81.818181818181810","18.1818181818181830","HOMEM"
"251650805000015","8","39","54","93","41.935483870967744","58.0645161290322560","MULHER"
"251650805000016","8","74","48","122","60.655737704918030","39.3442622950819700","HOMEM"
"251650805000017","8","146","51","197","74.111675126903550","25.8883248730964470","HOMEM"
"251650805000018","8","78","61","139","56.115107913669064","43.8848920863309360","HOMEM"
"251650805000019","8","169","31","200","84.500000000000000","15.5000000000000000","HOMEM"
"251650805000020","1","56","57","113","49.557522123893804","50.4424778761061960","MULHER"
"251650805000021","1","56","47","103","54.368932038834950","45.6310679611650500","HOMEM"
"251650805000022","1","134","82","216","62.037037037037040","37.9629629629629600","HOMEM"
"251650805000023","1","92","92","184","50.000000000000000","50.0000000000000000","IGUAL"
"251650805000024","1","106","90","196","54.081632653061230","45.9183673469387700","HOMEM"
"251650805000025","1","76","64","140","54.285714285714285","45.7142857142857150","HOMEM"
"251660705000001","1","40","32","72","55.555555555555560","44.4444444444444400","HOMEM"
"251660705000002","1","153","56","209","73.205741626794260","26.7942583732057430","HOMEM"
"251660705000003","1","50","39","89","56.179775280898870","43.8202247191011300","HOMEM"
"251660705000004","1","171","105","276","61.956521739130440","38.0434782608695600","HOMEM"
"251660705000005","1","105","54","159","66.037735849056600","33.9622641509434000","HOMEM"
"251660705000006","8","36","12","48","75.000000000000000","25.0000000000000000","HOMEM"
"251660705000007","8","175","45","220","79.545454545454550","20.4545454545454530","HOMEM"
"251660705000008","8","26","5","31","83.870967741935490","16.1290322580645160","HOMEM"
"251660705000009","8","112","59","171","65.497076023391810","34.5029239766081900","HOMEM"
"251660705000010","8","111","67","178","62.359550561797754","37.6404494382022460","HOMEM"
"251660705000011","8","101","26","127","79.527559055118100","20.4724409448818900","HOMEM"
"251660705000012","8","31","12","43","72.093023255813950","27.9069767441860460","HOMEM"
"251660705000013","8","79","26","105","75.238095238095240","24.7619047619047630","HOMEM"
"251660705000014","5","85","21","106","80.188679245283010","19.8113207547169800","HOMEM"
"251660705000015","8","64","16","80","80.000000000000000","20.0000000000000000","HOMEM"
"251660705000016","5","67","59","126","53.174603174603180","46.8253968253968200","HOMEM"
"251660705000017","5","98","28","126","77.777777777777770","22.2222222222222200","HOMEM"
"251660705000018","1","112","49","161","69.565217391304340","30.4347826086956520","HOMEM"
"251660705000019","1","96","54","150","64.000000000000000","36.0000000000000000","HOMEM"
"251660705000020","1","89","56","145","61.379310344827590","38.6206896551724100","HOMEM"
"251660705000021","1","77","49","126","61.111111111111114","38.8888888888888860","HOMEM"
"251660705000022","1","174","100","274","63.503649635036496","36.4963503649635040","HOMEM"
"251660705000023","1","152","93","245","62.040816326530610","37.9591836734693900","HOMEM"
"251660705000024","8","96","41","137","70.072992700729930","29.9270072992700730","HOMEM"
"251660705000025","8","87","68","155","56.129032258064520","43.8709677419354800","HOMEM"
"251660705000026","5","94","56","150","62.666666666666664","37.3333333333333360","HOMEM"
"251660705000027","5","19","6","25","76.000000000000000","24.0000000000000000","HOMEM"
"251660705000028","8","55","7","62","88.709677419354830","11.2903225806451620","HOMEM"
"251670605000001","1","140","131","271","51.660516605166050","48.3394833948339500","HOMEM"
"251670605000002","1","91","110","201","45.273631840796020","54.7263681592039800","MULHER"
"251670605000003","1","101","118","219","46.118721461187214","53.8812785388127860","MULHER"
"251670605000004","1","115","118","233","49.356223175965670","50.6437768240343300","MULHER"
"251670605000005","1","133","122","255","52.156862745098040","47.8431372549019600","HOMEM"
"251670605000006","1","114","203","317","35.962145110410090","64.0378548895899100","MULHER"
"251670605000007","1","14","72","86","16.279069767441860","83.7209302325581500","MULHER"
"251670605000008","1","93","71","164","56.707317073170735","43.2926829268292650","HOMEM"
"251670605000009","8","127","41","168","75.595238095238100","24.4047619047619050","HOMEM"
"251670605000010","8","48","201","249","19.277108433734940","80.7228915662650600","MULHER"
"251670605000011","8","49","24","73","67.123287671232870","32.8767123287671300","HOMEM"
"251670605000012","8","225","92","317","70.977917981072550","29.0220820189274460","HOMEM"
"251670605000013","8","110","54","164","67.073170731707320","32.9268292682926860","HOMEM"
"251670605000014","8","46","43","89","51.685393258426960","48.3146067415730400","HOMEM"
"251670605000015","8","71","35","106","66.981132075471690","33.0188679245283000","HOMEM"
"251670605000016","1","70","38","108","64.814814814814810","35.1851851851851800","HOMEM"
"251670605000017","1","133","111","244","54.508196721311480","45.4918032786885200","HOMEM"
"251670605000018","1","92","84","176","52.272727272727270","47.7272727272727300","HOMEM"
"251670605000019","1","115","124","239","48.117154811715480","51.8828451882845200","MULHER"
"251670605000020","1","206","118","324","63.580246913580250","36.4197530864197500","HOMEM"
"251675505000001","1","95","73","168","56.547619047619050","43.4523809523809500","HOMEM"
"251675505000002","8","92","64","156","58.974358974358970","41.0256410256410300","HOMEM"
"251675505000003","8","98","31","129","75.968992248062020","24.0310077519379850","HOMEM"
"251675505000004","1","103","63","166","62.048192771084340","37.9518072289156600","HOMEM"
"251675505000005","1","93","51","144","64.583333333333330","35.4166666666666640","HOMEM"
"251680505000001","1","76","97","173","43.930635838150290","56.0693641618497100","MULHER"
"251680505000002","1","168","97","265","63.396226415094340","36.6037735849056600","HOMEM"
"251680505000003","1","154","83","237","64.978902953586500","35.0210970464135000","HOMEM"
"251680505000004","8","110","22","132","83.333333333333330","16.6666666666666680","HOMEM"
"251680505000005","8","131","48","179","73.184357541899440","26.8156424581005600","HOMEM"
"251680505000006","8","81","25","106","76.415094339622640","23.5849056603773600","HOMEM"
"251680505000007","8","114","15","129","88.372093023255810","11.6279069767441850","HOMEM"
"251680505000008","8","99","41","140","70.714285714285710","29.2857142857142850","HOMEM"
"251680505000009","5","43","10","53","81.132075471698120","18.8679245283018880","HOMEM"
"251680505000010","8","79","17","96","82.291666666666670","17.7083333333333320","HOMEM"
"251680505000011","8","80","26","106","75.471698113207550","24.5283018867924520","HOMEM"
"251680505000012","8","82","17","99","82.828282828282820","17.1717171717171730","HOMEM"
"251680505000013","8","198","71","269","73.605947955390330","26.3940520446096660","HOMEM"
"251680505000014","1","179","113","292","61.301369863013700","38.6986301369863000","HOMEM"
"251680505000015","1","168","110","278","60.431654676258994","39.5683453237410060","HOMEM"
"251690405000001","1","197","126","323","60.990712074303400","39.0092879256966000","HOMEM"
"251690405000002","1","159","111","270","58.888888888888886","41.1111111111111140","HOMEM"
"251690405000003","1","95","102","197","48.223350253807105","51.7766497461928950","MULHER"
"251690405000004","1","217","88","305","71.147540983606560","28.8524590163934430","HOMEM"
"251690405000005","1","104","146","250","41.600000000000000","58.4000000000000000","MULHER"
"251690405000006","1","183","97","280","65.357142857142860","34.6428571428571460","HOMEM"
"251690405000007","1","136","55","191","71.204188481675390","28.7958115183246100","HOMEM"
"251690405000008","1","148","96","244","60.655737704918030","39.3442622950819700","HOMEM"
"251690405000009","8","162","35","197","82.233502538071060","17.7664974619289350","HOMEM"
"251690405000010","5","52","25","77","67.532467532467540","32.4675324675324650","HOMEM"
"251690405000011","8","150","24","174","86.206896551724140","13.7931034482758610","HOMEM"
"251690405000012","8","141","19","160","88.125000000000000","11.8750000000000000","HOMEM"
"251690405000013","5","19","3","22","86.363636363636360","13.6363636363636370","HOMEM"
"251690405000014","5","69","17","86","80.232558139534890","19.7674418604651160","HOMEM"
"251690405000015","8","141","29","170","82.941176470588230","17.0588235294117640","HOMEM"
"251690405000016","8","92","6","98","93.877551020408160","6.1224489795918360","HOMEM"
"251690405000017","8","117","39","156","75.000000000000000","25.0000000000000000","HOMEM"
"251690405000018","5","47","41","88","53.409090909090910","46.5909090909090900","HOMEM"
"251690405000019","1","138","75","213","64.788732394366190","35.2112676056338000","HOMEM"
"251690405000020","1","150","107","257","58.365758754863810","41.6342412451361900","HOMEM"
"251690405000021","1","142","103","245","57.959183673469390","42.0408163265306100","HOMEM"
"251690405000022","1","167","82","249","67.068273092369480","32.9317269076305200","HOMEM"
"251700105000001","1","192","113","305","62.950819672131146","37.0491803278688540","HOMEM"
"251700105000002","1","114","151","265","43.018867924528300","56.9811320754717000","MULHER"
"251700105000003","1","140","104","244","57.377049180327866","42.6229508196721340","HOMEM"
"251700105000004","1","41","215","256","16.015625000000000","83.9843750000000000","MULHER"
"251700105000005","8","52","43","95","54.736842105263160","45.2631578947368400","HOMEM"
"251700105000006","8","63","30","93","67.741935483870960","32.2580645161290300","HOMEM"
"251700105000007","8","43","104","147","29.251700680272110","70.7482993197278900","MULHER"
"251700105000008","8","152","68","220","69.090909090909100","30.9090909090909100","HOMEM"
"251700105000009","5","98","65","163","60.122699386503065","39.8773006134969350","HOMEM"
"251700105000010","5","23","18","41","56.097560975609750","43.9024390243902500","HOMEM"
"251700110000001","1","76","43","119","63.865546218487395","36.1344537815126050","HOMEM"
"251700110000002","8","101","111","212","47.641509433962260","52.3584905660377400","MULHER"
"251700110000003","8","175","82","257","68.093385214007780","31.9066147859922200","HOMEM"
"251700110000004","8","115","79","194","59.278350515463920","40.7216494845360800","HOMEM"
"251710005000001","1","197","119","316","62.341772151898730","37.6582278481012700","HOMEM"
"251710005000002","1","183","91","274","66.788321167883210","33.2116788321167900","HOMEM"
"251710005000003","8","103","6","109","94.495412844036700","5.5045871559633030","HOMEM"
"251710005000004","8","81","16","97","83.505154639175260","16.4948453608247400","HOMEM"
"251720905000001","1","196","86","282","69.503546099290790","30.4964539007092200","HOMEM"
"251720905000002","8","348","117","465","74.838709677419360","25.1612903225806440","HOMEM"
"251720905000003","8","193","63","256","75.390625000000000","24.6093750000000000","HOMEM"
"251720905000004","5","65","38","103","63.106796116504850","36.8932038834951500","HOMEM"
"251720905000005","8","272","38","310","87.741935483870960","12.2580645161290320","HOMEM"
"251740705000001","1","136","141","277","49.097472924187730","50.9025270758122700","MULHER"
"251740705000002","8","147","36","183","80.327868852459020","19.6721311475409840","HOMEM"
"251740705000003","1","110","101","211","52.132701421800945","47.8672985781990550","HOMEM"